type,value,user_num,user_loan_num,loan_rate,reloan_rate,num1,p1,num2,p2
bill_installment,0,3469941,109436,0.0315382884032,0.125233012903,95731,0.0275886535247,13705,0.00394963487852
bill_installment,1,101285,4141,0.0408846324727,0.167109393866,3449,0.0340524263218,692,0.00683220615096
bill_installment,2,217030,8685,0.0400175091001,0.172020725389,7191,0.0331336681565,1494,0.00688384094365
bill_installment,3,181159,8796,0.0485540326454,0.152341973624,7456,0.0411572154847,1340,0.00739681716062
bill_installment,4,217871,10534,0.0483497115265,0.162806151509,8819,0.0404780810663,1715,0.00787163046023
bill_installment,5,138178,8065,0.0583667443443,0.158586484811,6786,0.0491105675288,1279,0.00925617681541
bill_installment,6,190624,10553,0.0553602904146,0.168861934995,8771,0.0460120446533,1782,0.00934824576129
bill_installment,7,125614,7952,0.0633050456159,0.171780684105,6586,0.0524304615728,1366,0.0108745840432
bill_installment,8,157681,10097,0.0640343478288,0.175596711895,8324,0.0527901269018,1773,0.0112442209271
bill_installment,9,97053,7029,0.0724243454607,0.194764546877,5660,0.0583186506342,1369,0.0141056948265
bill_installment,10,119522,8890,0.0743796121216,0.181327334083,7278,0.0608925553455,1612,0.0134870567762
bill_installment,11,79280,6593,0.0831609485368,0.199150614288,5280,0.066599394551,1313,0.0165615539859
bill_installment,12,125188,9874,0.0788733744448,0.194450070893,7954,0.0635364411924,1920,0.0153369332524
bill_installment,13,73726,6413,0.0869842389388,0.199594573523,5133,0.0696226568646,1280,0.0173615820742
bill_installment,14,101768,9118,0.0895959437151,0.212107918403,7184,0.0705919345963,1934,0.0190040091188
bill_installment,15,63383,6027,0.0950885884228,0.224323875892,4675,0.0737579477147,1352,0.0213306407081
bill_installment,16,77453,7428,0.0959033220146,0.225767366721,5751,0.0742514815436,1677,0.021651840471
bill_installment,17,52974,5449,0.102861781251,0.230868049183,4191,0.0791142824782,1258,0.023747498773
bill_installment,18,66125,6701,0.101338374291,0.222354872407,5211,0.0788052930057,1490,0.0225330812854
bill_installment,19,47516,5099,0.107311221483,0.23337909394,3909,0.0822670258439,1190,0.0250441956394
bill_installment,20,61086,6469,0.105899878859,0.2260009275,5007,0.0819664080149,1462,0.0239334708444
bill_installment,21,45046,5081,0.112795808729,0.241684707735,3853,0.0855347866625,1228,0.0272610220663
bill_installment,22,50033,5795,0.115823556453,0.240034512511,4404,0.0880219055423,1391,0.0278016509104
bill_installment,23,38630,4634,0.119958581413,0.25312904618,3461,0.0895935801191,1173,0.0303650012943
bill_installment,24,53157,5942,0.1117820795,0.247896331202,4469,0.0840717120981,1473,0.0277103674022
bill_installment,25,36249,4392,0.121161963089,0.26912568306,3210,0.0885541670115,1182,0.0326077960771
bill_installment,26,41533,5047,0.121517829196,0.249851396869,3786,0.0911564298269,1261,0.0303613993692
bill_installment,27,33547,4211,0.125525382299,0.270957017336,3070,0.0915133991117,1141,0.0340119831878
bill_installment,28,42390,5129,0.120995517811,0.270423084422,3742,0.0882755366832,1387,0.0327199811276
bill_installment,29,30390,4141,0.136261928266,0.274571359575,3004,0.0988483053636,1137,0.0374136229023
bill_installment,30,36762,4779,0.12999836788,0.27892864616,3446,0.0937380991241,1333,0.0362602687558
bill_installment,31,28124,3902,0.138742710852,0.271655561251,2842,0.101052481866,1060,0.0376902289859
bill_installment,32,32997,4506,0.136557868897,0.280292942743,3243,0.0982816619693,1263,0.0382762069279
bill_installment,33,26374,3688,0.139834685675,0.296908893709,2593,0.0983165238492,1095,0.041518161826
bill_installment,34,28717,4100,0.142772573737,0.300487804878,2868,0.0998711564578,1232,0.042901417279
bill_installment,35,24577,3618,0.147210806852,0.290491984522,2567,0.104447247426,1051,0.0427635594255
bill_installment,36,29285,4073,0.139081441011,0.285293395532,2911,0.0994024244494,1162,0.0396790165614
bill_installment,37,22441,3341,0.148879283454,0.315773720443,2286,0.101867118221,1055,0.0470121652333
bill_installment,38,24904,3783,0.151903308705,0.308749669574,2615,0.105003212335,1168,0.0469000963701
bill_installment,39,21249,3335,0.156948562285,0.308545727136,2306,0.108522754012,1029,0.0484258082733
bill_installment,40,24932,3768,0.151131076528,0.301220806794,2633,0.105607251725,1135,0.0455238248035
bill_installment,41,19926,3250,0.163103482887,0.319076923077,2213,0.111060925424,1037,0.0520425574626
bill_installment,42,23753,3626,0.152654401549,0.30584666299,2517,0.105965562245,1109,0.0466888393045
bill_installment,43,18722,3078,0.164405512232,0.325536062378,2076,0.110885589146,1002,0.0535199230851
bill_installment,44,21230,3447,0.162364578427,0.306933565419,2389,0.112529439472,1058,0.0498351389543
bill_installment,45,18182,2944,0.161918380816,0.327785326087,1979,0.108843911561,965,0.0530744692553
bill_installment,46,19062,3181,0.166876508236,0.316252750707,2175,0.114101353478,1006,0.0527751547582
bill_installment,47,16350,2749,0.168134556575,0.335394688978,1827,0.111743119266,922,0.0563914373089
bill_installment,48,19329,3306,0.171038336179,0.323049001815,2238,0.115784572404,1068,0.0552537637746
bill_installment,49,15866,2768,0.174461111811,0.327312138728,1862,0.11735787218,906,0.0571032396319
bill_installment,50,17021,3024,0.177662887022,0.335317460317,2010,0.118089418953,1014,0.0595734680689
bill_installment,51,14856,2552,0.171782444803,0.349137931034,1661,0.111806677437,891,0.0599757673667
bill_installment,52,16457,2892,0.175730692107,0.327109266943,1946,0.118247554232,946,0.0574831378745
bill_installment,53,13836,2533,0.183073142527,0.353730754047,1637,0.118314541775,896,0.0647586007517
bill_installment,54,15444,2770,0.179357679358,0.341155234657,1825,0.118168868169,945,0.0611888111888
bill_installment,55,13244,2489,0.187934158864,0.347127360386,1625,0.122697070371,864,0.0652370884929
bill_installment,56,15421,2832,0.183645677972,0.323093220339,1917,0.124311004474,915,0.0593346734972
bill_installment,57,12686,2397,0.188948447107,0.351272423863,1555,0.122576068107,842,0.0663723790005
bill_installment,58,13749,2541,0.184813440978,0.352223534042,1646,0.119717797658,895,0.0650956433195
bill_installment,59,12063,2306,0.191163060599,0.340416305291,1521,0.126088037802,785,0.065075022797
bill_installment,60,13756,2553,0.185591741785,0.351351351351,1656,0.120383832509,897,0.065207909276
bill_installment,61,11505,2229,0.193741851369,0.35800807537,1431,0.124380704042,798,0.0693611473272
bill_installment,62,12318,2521,0.204659847378,0.368504561682,1592,0.129241760026,929,0.0754180873518
bill_installment,63,11073,2176,0.196514043168,0.368106617647,1375,0.124175923417,801,0.0723381197507
bill_installment,64,12221,2430,0.198838065625,0.362962962963,1548,0.126667212176,882,0.072170853449
bill_installment,65,10572,2213,0.209326522891,0.389516493448,1351,0.127790389709,862,0.081536133182
bill_installment,66,11253,2231,0.198258242247,0.349619004931,1451,0.128943392873,780,0.0693148493735
bill_installment,67,10198,2082,0.204157677976,0.35878962536,1335,0.130908021181,747,0.0732496567955
bill_installment,68,10772,2134,0.198106201263,0.344892221181,1398,0.129780913479,736,0.0683252877831
bill_installment,69,9753,2042,0.209371475443,0.370714985309,1285,0.131754332,757,0.077617143443
bill_installment,70,10587,2237,0.211296873524,0.368350469379,1413,0.133465570983,824,0.0778313025409
bill_installment,71,9224,1991,0.215849956635,0.386740331492,1221,0.132372072853,770,0.0834778837814
bill_installment,72,10337,2083,0.201509141917,0.378300528084,1295,0.125278127116,788,0.0762310148012
bill_installment,73,8678,1849,0.21306752708,0.374256354786,1157,0.133325651072,692,0.0797418760083
bill_installment,74,9282,2045,0.220318896789,0.384841075795,1258,0.135531135531,787,0.0847877612583
bill_installment,75,8420,1829,0.217220902613,0.387096774194,1121,0.133135391924,708,0.0840855106888
bill_installment,76,9098,1937,0.212903934931,0.391843056273,1178,0.129479006375,759,0.0834249285557
bill_installment,77,8133,1747,0.214803885405,0.400114481969,1048,0.128857740071,699,0.0859461453338
bill_installment,78,8805,1948,0.221237932993,0.395790554415,1177,0.133674048836,771,0.0875638841567
bill_installment,79,7708,1756,0.227815256876,0.421412300683,1016,0.131811105345,740,0.0960041515309
bill_installment,80,8378,1862,0.222248746718,0.387218045113,1141,0.136190021485,721,0.0860587252328
bill_installment,81,7497,1719,0.229291716687,0.404886561955,1023,0.136454581833,696,0.0928371348539
bill_installment,82,7923,1803,0.227565316168,0.411536328342,1061,0.133913921494,742,0.0936513946737
bill_installment,83,7155,1683,0.235220125786,0.398692810458,1012,0.14143955276,671,0.0937805730259
bill_installment,84,7897,1804,0.228441180195,0.417405764967,1051,0.133088514626,753,0.0953526655692
bill_installment,85,6860,1568,0.228571428571,0.406887755102,930,0.13556851312,638,0.0930029154519
bill_installment,86,7389,1684,0.227906347273,0.387173396675,1032,0.139667072676,652,0.0882392745974
bill_installment,87,6483,1544,0.238161345056,0.416450777202,901,0.138978867808,643,0.0991824772482
bill_installment,88,6957,1572,0.225959465287,0.405216284987,935,0.134397010206,637,0.0915624550812
bill_installment,89,6380,1513,0.237147335423,0.419695968275,878,0.137617554859,635,0.0995297805643
bill_installment,90,6949,1626,0.233990502231,0.39975399754,976,0.140451863577,650,0.093538638653
bill_installment,91,6217,1468,0.236126749236,0.426430517711,842,0.135435097314,626,0.100691651922
bill_installment,92,6552,1485,0.226648351648,0.411447811448,874,0.133394383394,611,0.093253968254
bill_installment,93,5927,1498,0.252741690569,0.407209612817,888,0.149822844609,610,0.102918845959
bill_installment,94,6246,1539,0.246397694524,0.429499675114,878,0.140569964777,661,0.105827729747
bill_installment,95,5687,1491,0.262176894672,0.433266264252,845,0.148584490944,646,0.113592403728
bill_installment,96,6271,1513,0.241269335034,0.420356906808,877,0.139850103652,636,0.101419231383
bill_installment,97,5477,1384,0.252693080153,0.429913294798,789,0.144056965492,595,0.108636114661
bill_installment,98,5806,1466,0.252497416466,0.425648021828,842,0.14502239063,624,0.107475025835
bill_installment,99,5361,1354,0.252564819996,0.449778434269,745,0.138966610707,609,0.113598209289
bill_installment,100,5712,1404,0.245798319328,0.439458689459,787,0.137780112045,617,0.108018207283
bill_installment,101,5106,1310,0.256560908735,0.434351145038,741,0.145123384254,569,0.111437524481
bill_installment,102,5515,1399,0.25367180417,0.433166547534,793,0.143789664551,606,0.109882139619
bill_installment,103,5119,1304,0.25473725337,0.446319018405,722,0.141043172495,582,0.113694080875
bill_installment,104,5385,1383,0.256824512535,0.427331887202,792,0.147075208914,591,0.109749303621
bill_installment,105,4968,1302,0.262077294686,0.437019969278,733,0.147544283414,569,0.114533011272
bill_installment,106,5070,1332,0.262721893491,0.447447447447,736,0.14516765286,596,0.117554240631
bill_installment,107,4663,1234,0.264636500107,0.459481361426,667,0.143040960755,567,0.121595539352
bill_installment,108,4969,1245,0.250553431274,0.439357429719,698,0.140470919702,547,0.110082511572
bill_installment,109,4612,1225,0.265611448395,0.42693877551,702,0.152211621856,523,0.113399826539
bill_installment,110,4797,1266,0.263914946842,0.443917851501,704,0.146758390661,562,0.117156556181
bill_installment,111,4409,1183,0.268314810615,0.468300929839,629,0.142662735314,554,0.125652075301
bill_installment,112,4687,1207,0.257520802219,0.434962717481,682,0.145508854278,525,0.112011947941
bill_installment,113,4275,1167,0.27298245614,0.470437017995,618,0.144561403509,549,0.128421052632
bill_installment,114,4526,1235,0.272867874503,0.451821862348,677,0.14958020327,558,0.123287671233
bill_installment,115,4049,1038,0.256359594962,0.461464354528,559,0.138058779946,479,0.118300815016
bill_installment,116,4171,1105,0.264924478542,0.458823529412,598,0.14337089427,507,0.121553584272
bill_installment,117,3882,1109,0.285677485832,0.457168620379,602,0.155074703761,507,0.130602782071
bill_installment,118,4208,1147,0.272576045627,0.456843940715,623,0.148051330798,524,0.124524714829
bill_installment,119,3882,1114,0.28696548171,0.45960502693,602,0.155074703761,512,0.13189077795
bill_installment,120,4123,1121,0.271889400922,0.483496877788,579,0.140431724472,542,0.131457676449
bill_installment,121,3767,1085,0.288027608176,0.470967741935,574,0.152375895938,511,0.135651712238
bill_installment,122,3847,1122,0.291655835716,0.458110516934,608,0.158045230049,514,0.133610605667
bill_installment,123,3589,1052,0.293117860128,0.468631178707,559,0.155753691836,493,0.137364168292
bill_installment,124,3679,1061,0.288393585213,0.438265786993,596,0.162000543626,465,0.126393041587
bill_installment,125,3380,963,0.284911242604,0.458982346833,521,0.154142011834,442,0.130769230769
bill_installment,126,3742,1096,0.292891501871,0.484489051095,565,0.150988776056,531,0.141902725815
bill_installment,127,3380,975,0.288461538462,0.447179487179,539,0.159467455621,436,0.12899408284
bill_installment,128,3659,1077,0.294342716589,0.454038997214,588,0.160699644712,489,0.133643071878
bill_installment,129,3363,993,0.295272078501,0.471299093656,525,0.156110615522,468,0.139161462979
bill_installment,130,3519,1022,0.290423415743,0.439334637965,573,0.162830349531,449,0.127593066212
bill_installment,131,3185,969,0.304238618524,0.453044375645,530,0.166405023548,439,0.137833594976
bill_installment,132,3456,986,0.285300925926,0.45537525355,537,0.155381944444,449,0.129918981481
bill_installment,133,3148,933,0.296378653113,0.489817792069,476,0.151207115629,457,0.145171537484
bill_installment,134,3213,962,0.29940865235,0.475051975052,505,0.157173980703,457,0.142234671646
bill_installment,135,2995,918,0.306510851419,0.483660130719,474,0.158263772955,444,0.148247078464
bill_installment,136,3190,916,0.287147335423,0.505458515284,453,0.142006269592,463,0.145141065831
bill_installment,137,2964,913,0.308029689609,0.483023001095,472,0.159244264507,441,0.148785425101
bill_installment,138,3086,915,0.296500324044,0.481967213115,474,0.153596889177,441,0.142903434867
bill_installment,139,2901,883,0.304377800758,0.493771234428,447,0.154084798345,436,0.150293002413
bill_installment,140,3040,926,0.304605263158,0.47192224622,489,0.160855263158,437,0.14375
bill_installment,141,2852,870,0.305049088359,0.498850574713,436,0.152875175316,434,0.152173913043
bill_installment,142,2932,896,0.305593451569,0.529017857143,422,0.143929058663,474,0.161664392906
bill_installment,143,2722,855,0.314107274063,0.494736842105,432,0.158706833211,423,0.155400440852
bill_installment,144,2919,885,0.30318602261,0.482485875706,458,0.156903048989,427,0.146282973621
bill_installment,145,2689,814,0.302714763853,0.501228501229,406,0.150985496467,408,0.151729267386
bill_installment,146,2777,864,0.311127115592,0.496527777778,435,0.156643860281,429,0.154483255311
bill_installment,147,2636,829,0.314491654021,0.496984318456,417,0.158194233687,412,0.156297420334
bill_installment,148,2752,847,0.307776162791,0.479338842975,441,0.160247093023,406,0.147529069767
bill_installment,149,2601,817,0.314109957709,0.501835985312,407,0.156478277586,410,0.157631680123
bill_installment,150,2673,822,0.307519640853,0.496350364964,414,0.154882154882,408,0.152637485971
bill_installment,151,2510,804,0.3203187251,0.477611940299,420,0.167330677291,384,0.152988047809
bill_installment,152,2565,820,0.319688109162,0.508536585366,403,0.157115009747,417,0.162573099415
bill_installment,153,2426,730,0.300906842539,0.495890410959,368,0.151690024732,362,0.149216817807
bill_installment,154,2490,783,0.314457831325,0.490421455939,399,0.160240963855,384,0.15421686747
bill_installment,155,2330,804,0.345064377682,0.506218905473,397,0.170386266094,407,0.174678111588
bill_installment,156,2392,770,0.321906354515,0.503896103896,382,0.159698996656,388,0.16220735786
bill_installment,157,2276,705,0.309753954306,0.486524822695,362,0.159050966608,343,0.150702987698
bill_installment,158,2334,775,0.33204798629,0.495483870968,391,0.167523564696,384,0.164524421594
bill_installment,159,2183,696,0.318827301878,0.51724137931,336,0.153916628493,360,0.164910673385
bill_installment,160,2262,735,0.324933687003,0.499319727891,368,0.162687886826,367,0.162245800177
bill_installment,161,2184,734,0.336080586081,0.514986376022,356,0.163003663004,378,0.173076923077
bill_installment,162,2169,711,0.327800829876,0.492264416315,361,0.166436145689,350,0.161364684186
bill_installment,163,2127,701,0.329572167372,0.53209700428,328,0.154207804419,373,0.175364362953
bill_installment,164,2203,686,0.311393554244,0.545189504373,312,0.141625056741,374,0.169768497503
bill_installment,165,2087,665,0.318639195017,0.566917293233,288,0.13799712506,377,0.180642069957
bill_installment,166,2085,697,0.334292565947,0.509325681492,342,0.164028776978,355,0.170263788969
bill_installment,167,2002,666,0.332667332667,0.516516516517,322,0.160839160839,344,0.171828171828
bill_installment,168,2136,690,0.323033707865,0.507246376812,340,0.159176029963,350,0.163857677903
bill_installment,169,1880,615,0.327127659574,0.531707317073,288,0.153191489362,327,0.173936170213
bill_installment,170,1968,653,0.331808943089,0.53751914242,302,0.153455284553,351,0.178353658537
bill_installment,171,1937,641,0.330924109448,0.535101404056,298,0.153846153846,343,0.177077955601
bill_installment,172,1941,669,0.344667697063,0.518684603886,322,0.16589386914,347,0.178773827924
bill_installment,173,1790,566,0.316201117318,0.526501766784,268,0.149720670391,298,0.166480446927
bill_installment,174,1931,663,0.343345416882,0.506787330317,327,0.169342309684,336,0.174003107198
bill_installment,175,1920,662,0.344791666667,0.536253776435,307,0.159895833333,355,0.184895833333
bill_installment,176,1958,647,0.330439223698,0.531684698609,303,0.154749744637,344,0.17568947906
bill_installment,177,1791,621,0.346733668342,0.515297906602,301,0.168062534897,320,0.178671133445
bill_installment,178,1772,565,0.318848758465,0.499115044248,283,0.159706546275,282,0.15914221219
bill_installment,179,1781,589,0.330713082538,0.522920203735,281,0.157776530039,308,0.172936552499
bill_installment,180,1825,611,0.334794520548,0.515548281506,296,0.162191780822,315,0.172602739726
bill_installment,181,1718,605,0.352153667055,0.535537190083,281,0.163562281723,324,0.188591385332
bill_installment,182,1733,608,0.350836699365,0.542763157895,278,0.160415464512,330,0.190421234853
bill_installment,183,1637,575,0.351252290776,0.542608695652,263,0.160659743433,312,0.190592547343
bill_installment,184,1720,573,0.333139534884,0.528795811518,270,0.156976744186,303,0.176162790698
bill_installment,185,1617,575,0.355596784168,0.504347826087,285,0.176252319109,290,0.179344465059
bill_installment,186,1696,598,0.352594339623,0.533444816054,279,0.164504716981,319,0.188089622642
bill_installment,187,1584,535,0.337752525253,0.521495327103,256,0.161616161616,279,0.176136363636
bill_installment,188,1688,583,0.345379146919,0.492281303602,296,0.175355450237,287,0.170023696682
bill_installment,189,1545,556,0.359870550162,0.5,278,0.179935275081,278,0.179935275081
bill_installment,190,1582,550,0.347661188369,0.534545454545,256,0.161820480405,294,0.185840707965
bill_installment,191,1486,517,0.347913862719,0.535783365571,240,0.161507402423,277,0.186406460296
bill_installment,192,1534,525,0.342242503259,0.542857142857,240,0.156453715776,285,0.185788787484
bill_installment,193,1439,548,0.380820013899,0.509124087591,269,0.186935371786,279,0.193884642113
bill_installment,194,1546,569,0.368046571798,0.527240773286,269,0.173997412678,300,0.19404915912
bill_installment,195,1437,519,0.361169102296,0.562620423892,227,0.157967988866,292,0.203201113431
bill_installment,196,1482,497,0.335357624831,0.539235412475,229,0.154520917679,268,0.180836707152
bill_installment,197,1391,502,0.360891445004,0.529880478088,236,0.169662113587,266,0.191229331416
bill_installment,198,1447,483,0.333794056669,0.577639751553,204,0.140981340705,279,0.192812715964
bill_installment,199,1408,522,0.370738636364,0.538314176245,241,0.171164772727,281,0.199573863636
bill_installment,200,1425,510,0.357894736842,0.529411764706,240,0.168421052632,270,0.189473684211
bill_installment,201,1311,468,0.356979405034,0.527777777778,221,0.168573607933,247,0.188405797101
bill_installment,202,1429,516,0.361091672498,0.498062015504,259,0.181245626312,257,0.179846046186
bill_installment,203,1312,460,0.350609756098,0.567391304348,199,0.151676829268,261,0.198932926829
bill_installment,204,1433,526,0.367062107467,0.543726235741,240,0.167480809491,286,0.199581297976
bill_installment,205,1241,457,0.368251410153,0.575492341357,194,0.156325543916,263,0.211925866237
bill_installment,206,1323,508,0.383975812547,0.557086614173,225,0.170068027211,283,0.213907785336
bill_installment,207,1293,487,0.376643464811,0.546201232033,221,0.170920340294,266,0.205723124517
bill_installment,208,1315,461,0.350570342205,0.522776572668,220,0.167300380228,241,0.183269961977
bill_installment,209,1225,482,0.393469387755,0.558091286307,213,0.17387755102,269,0.219591836735
bill_installment,210,1295,491,0.379150579151,0.543788187373,224,0.172972972973,267,0.206177606178
bill_installment,211,1203,446,0.370739817124,0.529147982063,210,0.174563591022,236,0.196176226101
bill_installment,212,1234,458,0.371150729335,0.550218340611,206,0.166936790924,252,0.204213938412
bill_installment,213,1196,433,0.362040133779,0.568129330254,187,0.15635451505,246,0.205685618729
bill_installment,214,1178,448,0.380305602716,0.558035714286,198,0.168081494058,250,0.212224108659
bill_installment,215,1138,417,0.366432337434,0.553956834532,186,0.163444639719,231,0.202987697715
bill_installment,216,1202,416,0.34608985025,0.512019230769,203,0.168885191348,213,0.177204658902
bill_installment,217,1119,450,0.402144772118,0.553333333333,201,0.179624664879,249,0.222520107239
bill_installment,218,1237,424,0.342764753436,0.558962264151,187,0.151172190784,237,0.191592562652
bill_installment,219,1031,382,0.370514064016,0.570680628272,164,0.159068865179,218,0.211445198836
bill_installment,220,1169,437,0.373823781009,0.556064073227,194,0.165953806672,243,0.207869974337
bill_installment,221,1155,420,0.363636363636,0.557142857143,186,0.161038961039,234,0.202597402597
bill_installment,222,1155,450,0.38961038961,0.544444444444,205,0.177489177489,245,0.212121212121
bill_installment,223,1066,388,0.363977485929,0.55412371134,173,0.162288930582,215,0.201688555347
bill_installment,224,1098,381,0.346994535519,0.551181102362,171,0.155737704918,210,0.191256830601
bill_installment,225,1036,372,0.359073359073,0.577956989247,157,0.151544401544,215,0.207528957529
bill_installment,226,1057,409,0.386944181646,0.58435207824,170,0.160832544939,239,0.226111636708
bill_installment,227,1029,387,0.376093294461,0.56330749354,169,0.164237123421,218,0.21185617104
bill_installment,228,1047,402,0.383954154728,0.544776119403,183,0.174785100287,219,0.209169054441
bill_installment,229,1033,400,0.387221684414,0.5875,165,0.159728944821,235,0.227492739593
bill_installment,230,1050,363,0.345714285714,0.6391184573,131,0.124761904762,232,0.220952380952
bill_installment,231,992,388,0.391129032258,0.574742268041,165,0.166330645161,223,0.224798387097
bill_installment,232,1085,418,0.385253456221,0.540669856459,192,0.176958525346,226,0.208294930876
bill_installment,233,948,359,0.378691983122,0.562674094708,157,0.165611814346,202,0.213080168776
bill_installment,234,944,353,0.373940677966,0.552407932011,158,0.167372881356,195,0.20656779661
bill_installment,235,979,388,0.396322778345,0.54381443299,177,0.180796731359,211,0.215526046987
bill_installment,236,990,361,0.364646464646,0.520775623269,173,0.174747474747,188,0.189898989899
bill_installment,237,913,343,0.375684556407,0.577259475219,145,0.158817086528,198,0.21686746988
bill_installment,238,954,372,0.389937106918,0.569892473118,160,0.167714884696,212,0.222222222222
bill_installment,239,919,360,0.391730141458,0.55,162,0.176278563656,198,0.215451577802
bill_installment,240,936,370,0.395299145299,0.564864864865,161,0.172008547009,209,0.223290598291
bill_installment,241,867,323,0.372549019608,0.557275541796,143,0.16493656286,180,0.207612456747
bill_installment,242,929,389,0.418729817008,0.557840616967,172,0.185145317546,217,0.233584499462
bill_installment,243,866,342,0.394919168591,0.622807017544,129,0.14896073903,213,0.245958429561
bill_installment,244,872,332,0.380733944954,0.611445783133,129,0.147935779817,203,0.232798165138
bill_installment,245,850,340,0.4,0.588235294118,140,0.164705882353,200,0.235294117647
bill_installment,246,933,357,0.382636655949,0.546218487395,162,0.173633440514,195,0.209003215434
bill_installment,247,831,339,0.407942238267,0.587020648968,140,0.168471720818,199,0.239470517449
bill_installment,248,841,302,0.359096313912,0.596026490066,122,0.145065398335,180,0.214030915577
bill_installment,249,833,322,0.386554621849,0.577639751553,136,0.163265306122,186,0.223289315726
bill_installment,250,880,355,0.403409090909,0.588732394366,146,0.165909090909,209,0.2375
bill_installment,251,793,320,0.403530895334,0.58125,134,0.168978562421,186,0.234552332913
bill_installment,252,868,331,0.38133640553,0.592145015106,135,0.155529953917,196,0.225806451613
bill_installment,253,797,308,0.386449184442,0.633116883117,113,0.141781681305,195,0.244667503137
bill_installment,254,843,345,0.409252669039,0.611594202899,134,0.158956109134,211,0.250296559905
bill_installment,255,789,308,0.390367553866,0.571428571429,132,0.167300380228,176,0.223067173638
bill_installment,256,845,326,0.385798816568,0.59509202454,132,0.156213017751,194,0.229585798817
bill_installment,257,814,323,0.396805896806,0.551083591331,145,0.178132678133,178,0.218673218673
bill_installment,258,793,317,0.39974779319,0.570977917981,136,0.171500630517,181,0.228247162673
bill_installment,259,789,316,0.400506970849,0.610759493671,123,0.155893536122,193,0.244613434728
bill_installment,260,794,342,0.430730478589,0.616959064327,131,0.164987405542,211,0.265743073048
bill_installment,261,780,322,0.412820512821,0.577639751553,136,0.174358974359,186,0.238461538462
bill_installment,262,796,354,0.44472361809,0.573446327684,151,0.189698492462,203,0.255025125628
bill_installment,263,751,311,0.414114513981,0.556270096463,138,0.183754993342,173,0.230359520639
bill_installment,264,789,320,0.405576679341,0.5875,132,0.167300380228,188,0.238276299113
bill_installment,265,736,280,0.380434782609,0.639285714286,101,0.13722826087,179,0.243206521739
bill_installment,266,726,300,0.413223140496,0.626666666667,112,0.154269972452,188,0.258953168044
bill_installment,267,714,308,0.43137254902,0.652597402597,107,0.149859943978,201,0.281512605042
bill_installment,268,749,301,0.401869158879,0.594684385382,122,0.162883845127,179,0.238985313752
bill_installment,269,734,315,0.429155313351,0.612698412698,122,0.16621253406,193,0.262942779292
bill_installment,270,755,313,0.414569536424,0.565495207668,136,0.180132450331,177,0.234437086093
bill_installment,271,751,296,0.39414114514,0.577702702703,125,0.166444740346,171,0.227696404794
bill_installment,272,755,335,0.443708609272,0.641791044776,120,0.158940397351,215,0.284768211921
bill_installment,273,709,274,0.386459802539,0.627737226277,102,0.143864598025,172,0.242595204513
bill_installment,274,706,305,0.432011331445,0.577049180328,129,0.182719546742,176,0.249291784703
bill_installment,275,738,314,0.425474254743,0.582802547771,131,0.177506775068,183,0.247967479675
bill_installment,276,672,280,0.416666666667,0.592857142857,114,0.169642857143,166,0.247023809524
bill_installment,277,645,254,0.393798449612,0.606299212598,100,0.15503875969,154,0.238759689922
bill_installment,278,687,302,0.439592430859,0.582781456954,126,0.183406113537,176,0.256186317322
bill_installment,279,619,260,0.420032310178,0.596153846154,105,0.169628432956,155,0.250403877221
bill_installment,280,586,261,0.445392491468,0.567049808429,113,0.192832764505,148,0.252559726962
bill_installment,281,632,276,0.436708860759,0.597826086957,111,0.175632911392,165,0.261075949367
bill_installment,282,634,249,0.392744479495,0.59437751004,101,0.159305993691,148,0.233438485804
bill_installment,283,634,250,0.394321766562,0.632,92,0.145110410095,158,0.249211356467
bill_installment,284,641,274,0.427457098284,0.624087591241,103,0.160686427457,171,0.266770670827
bill_installment,285,615,237,0.385365853659,0.658227848101,81,0.131707317073,156,0.253658536585
bill_installment,286,620,261,0.420967741935,0.544061302682,119,0.191935483871,142,0.229032258065
bill_installment,287,612,269,0.43954248366,0.579925650558,113,0.184640522876,156,0.254901960784
bill_installment,288,687,283,0.411935953421,0.614840989399,109,0.15866084425,174,0.25327510917
bill_installment,289,561,241,0.429590017825,0.560165975104,106,0.188948306595,135,0.24064171123
bill_installment,290,612,256,0.418300653595,0.61328125,99,0.161764705882,157,0.256535947712
bill_installment,291,541,234,0.432532347505,0.57264957265,100,0.184842883549,134,0.247689463956
bill_installment,292,604,267,0.442052980132,0.576779026217,113,0.187086092715,154,0.254966887417
bill_installment,293,586,253,0.431740614334,0.608695652174,99,0.168941979522,154,0.262798634812
bill_installment,294,606,239,0.394389438944,0.581589958159,100,0.16501650165,139,0.229372937294
bill_installment,295,583,238,0.408233276158,0.626050420168,89,0.152658662093,149,0.255574614065
bill_installment,296,610,259,0.424590163934,0.590733590734,106,0.173770491803,153,0.250819672131
bill_installment,297,555,222,0.4,0.59009009009,91,0.163963963964,131,0.236036036036
bill_installment,298,584,247,0.422945205479,0.619433198381,94,0.16095890411,153,0.26198630137
bill_installment,299,533,227,0.425891181989,0.590308370044,93,0.174484052533,134,0.251407129456
bill_installment,300,560,239,0.426785714286,0.569037656904,103,0.183928571429,136,0.242857142857
bill_installment,301,523,226,0.432122370937,0.610619469027,88,0.168260038241,138,0.263862332696
bill_installment,302,521,227,0.435700575816,0.656387665198,78,0.149712092131,149,0.285988483685
bill_installment,303,514,221,0.429961089494,0.570135746606,95,0.184824902724,126,0.24513618677
bill_installment,304,500,207,0.414,0.594202898551,84,0.168,123,0.246
bill_installment,305,538,206,0.382899628253,0.567961165049,89,0.165427509294,117,0.217472118959
bill_installment,306,541,231,0.426987060998,0.636363636364,84,0.155268022181,147,0.271719038817
bill_installment,307,517,237,0.458413926499,0.637130801688,86,0.166344294004,151,0.292069632495
bill_installment,308,511,210,0.41095890411,0.585714285714,87,0.170254403131,123,0.240704500978
bill_installment,309,507,242,0.477317554241,0.636363636364,88,0.173570019724,154,0.303747534517
bill_installment,310,493,214,0.434077079108,0.593457943925,87,0.176470588235,127,0.257606490872
bill_installment,311,465,196,0.421505376344,0.709183673469,57,0.122580645161,139,0.298924731183
bill_installment,312,424,178,0.419811320755,0.629213483146,66,0.155660377358,112,0.264150943396
bill_installment,313,466,198,0.424892703863,0.585858585859,82,0.175965665236,116,0.248927038627
bill_installment,314,486,213,0.438271604938,0.615023474178,82,0.168724279835,131,0.269547325103
bill_installment,315,479,199,0.415448851775,0.582914572864,83,0.173277661795,116,0.242171189979
bill_installment,316,506,225,0.444664031621,0.662222222222,76,0.150197628458,149,0.294466403162
bill_installment,317,497,243,0.48893360161,0.600823045267,97,0.195171026157,146,0.293762575453
bill_installment,318,467,190,0.406852248394,0.615789473684,73,0.156316916488,117,0.250535331906
bill_installment,319,455,182,0.4,0.565934065934,79,0.173626373626,103,0.226373626374
bill_installment,320,494,254,0.514170040486,0.59842519685,102,0.206477732794,152,0.307692307692
bill_installment,321,483,214,0.443064182195,0.579439252336,90,0.186335403727,124,0.256728778468
bill_installment,322,463,192,0.414686825054,0.546875,87,0.187904967603,105,0.226781857451
bill_installment,323,438,199,0.454337899543,0.562814070352,87,0.198630136986,112,0.255707762557
bill_installment,324,477,214,0.448637316562,0.602803738318,85,0.17819706499,129,0.270440251572
bill_installment,325,443,212,0.47855530474,0.61320754717,82,0.185101580135,130,0.293453724605
bill_installment,326,460,205,0.445652173913,0.643902439024,73,0.158695652174,132,0.286956521739
bill_installment,327,422,184,0.436018957346,0.663043478261,62,0.14691943128,122,0.289099526066
bill_installment,328,452,192,0.424778761062,0.567708333333,83,0.183628318584,109,0.241150442478
bill_installment,329,420,185,0.440476190476,0.616216216216,71,0.169047619048,114,0.271428571429
bill_installment,330,425,190,0.447058823529,0.578947368421,80,0.188235294118,110,0.258823529412
bill_installment,331,463,205,0.442764578834,0.69756097561,62,0.133909287257,143,0.308855291577
bill_installment,332,429,185,0.431235431235,0.610810810811,72,0.167832167832,113,0.263403263403
bill_installment,333,397,177,0.445843828715,0.64406779661,63,0.158690176322,114,0.287153652393
bill_installment,334,410,191,0.465853658537,0.659685863874,65,0.158536585366,126,0.307317073171
bill_installment,335,420,190,0.452380952381,0.589473684211,78,0.185714285714,112,0.266666666667
bill_installment,336,433,195,0.450346420323,0.610256410256,76,0.175519630485,119,0.274826789838
bill_installment,337,373,180,0.482573726542,0.661111111111,61,0.163538873995,119,0.319034852547
bill_installment,338,415,195,0.469879518072,0.610256410256,76,0.18313253012,119,0.286746987952
bill_installment,339,399,183,0.458646616541,0.622950819672,69,0.172932330827,114,0.285714285714
bill_installment,340,419,203,0.484486873508,0.546798029557,92,0.219570405728,111,0.26491646778
bill_installment,341,371,153,0.412398921833,0.607843137255,60,0.161725067385,93,0.250673854447
bill_installment,342,381,163,0.42782152231,0.656441717791,56,0.146981627297,107,0.280839895013
bill_installment,343,403,176,0.436724565757,0.653409090909,61,0.151364764268,115,0.285359801489
bill_installment,344,369,147,0.39837398374,0.52380952381,70,0.189701897019,77,0.208672086721
bill_installment,345,355,157,0.442253521127,0.649681528662,55,0.154929577465,102,0.287323943662
bill_installment,346,392,165,0.420918367347,0.563636363636,72,0.183673469388,93,0.237244897959
bill_installment,347,366,155,0.42349726776,0.645161290323,55,0.150273224044,100,0.273224043716
bill_installment,348,380,175,0.460526315789,0.64,63,0.165789473684,112,0.294736842105
bill_installment,349,325,151,0.464615384615,0.622516556291,57,0.175384615385,94,0.289230769231
bill_installment,350,375,170,0.453333333333,0.605882352941,67,0.178666666667,103,0.274666666667
bill_installment,351,352,165,0.46875,0.642424242424,59,0.167613636364,106,0.301136363636
bill_installment,352,377,168,0.445623342175,0.684523809524,53,0.140583554377,115,0.305039787798
bill_installment,353,371,162,0.436657681941,0.537037037037,75,0.202156334232,87,0.234501347709
bill_installment,354,357,168,0.470588235294,0.630952380952,62,0.173669467787,106,0.296918767507
bill_installment,355,325,145,0.446153846154,0.634482758621,53,0.163076923077,92,0.283076923077
bill_installment,356,359,177,0.493036211699,0.570621468927,76,0.211699164345,101,0.281337047354
bill_installment,357,355,149,0.419718309859,0.590604026846,61,0.171830985915,88,0.247887323944
bill_installment,358,364,163,0.447802197802,0.60736196319,64,0.175824175824,99,0.271978021978
bill_installment,359,311,159,0.511254019293,0.584905660377,66,0.212218649518,93,0.299035369775
bill_installment,360,315,148,0.469841269841,0.722972972973,41,0.130158730159,107,0.339682539683
bill_installment,361,360,159,0.441666666667,0.622641509434,60,0.166666666667,99,0.275
bill_installment,362,332,157,0.472891566265,0.579617834395,66,0.198795180723,91,0.274096385542
bill_installment,363,354,161,0.454802259887,0.60248447205,64,0.180790960452,97,0.274011299435
bill_installment,364,329,148,0.449848024316,0.581081081081,62,0.188449848024,86,0.261398176292
bill_installment,365,307,131,0.42671009772,0.648854961832,46,0.14983713355,85,0.276872964169
bill_installment,366,364,183,0.502747252747,0.655737704918,63,0.173076923077,120,0.32967032967
bill_installment,367,319,159,0.498432601881,0.59748427673,64,0.200626959248,95,0.297805642633
bill_installment,368,330,153,0.463636363636,0.588235294118,63,0.190909090909,90,0.272727272727
bill_installment,369,305,142,0.465573770492,0.676056338028,46,0.150819672131,96,0.314754098361
bill_installment,370,296,116,0.391891891892,0.663793103448,39,0.131756756757,77,0.260135135135
bill_installment,371,305,149,0.488524590164,0.644295302013,53,0.173770491803,96,0.314754098361
bill_installment,372,305,125,0.409836065574,0.672,41,0.134426229508,84,0.275409836066
bill_installment,373,324,151,0.466049382716,0.622516556291,57,0.175925925926,94,0.29012345679
bill_installment,374,304,142,0.467105263158,0.647887323944,50,0.164473684211,92,0.302631578947
bill_installment,375,275,131,0.476363636364,0.63358778626,48,0.174545454545,83,0.301818181818
bill_installment,376,312,141,0.451923076923,0.553191489362,63,0.201923076923,78,0.25
bill_installment,377,308,155,0.503246753247,0.703225806452,46,0.149350649351,109,0.353896103896
bill_installment,378,299,128,0.428093645485,0.5703125,55,0.183946488294,73,0.244147157191
bill_installment,379,300,144,0.48,0.5625,63,0.21,81,0.27
bill_installment,380,302,142,0.470198675497,0.577464788732,60,0.198675496689,82,0.271523178808
bill_installment,381,303,138,0.455445544554,0.688405797101,43,0.141914191419,95,0.313531353135
bill_installment,382,285,138,0.484210526316,0.702898550725,41,0.143859649123,97,0.340350877193
bill_installment,383,275,122,0.443636363636,0.622950819672,46,0.167272727273,76,0.276363636364
bill_installment,384,317,142,0.447949526814,0.577464788732,60,0.18927444795,82,0.258675078864
bill_installment,385,256,130,0.5078125,0.653846153846,45,0.17578125,85,0.33203125
bill_installment,386,308,143,0.464285714286,0.671328671329,47,0.152597402597,96,0.311688311688
bill_installment,387,287,143,0.498257839721,0.643356643357,51,0.177700348432,92,0.320557491289
bill_installment,388,266,116,0.436090225564,0.646551724138,41,0.154135338346,75,0.281954887218
bill_installment,389,290,136,0.468965517241,0.691176470588,42,0.144827586207,94,0.324137931034
bill_installment,390,277,111,0.400722021661,0.630630630631,41,0.148014440433,70,0.252707581227
bill_installment,391,276,128,0.463768115942,0.609375,50,0.18115942029,78,0.282608695652
bill_installment,392,283,142,0.501766784452,0.669014084507,47,0.166077738516,95,0.335689045936
bill_installment,393,262,114,0.435114503817,0.710526315789,33,0.125954198473,81,0.309160305344
bill_installment,394,269,120,0.446096654275,0.7,36,0.133828996283,84,0.312267657993
bill_installment,395,259,133,0.513513513514,0.676691729323,43,0.166023166023,90,0.34749034749
bill_installment,396,268,129,0.481343283582,0.68992248062,40,0.149253731343,89,0.332089552239
bill_installment,397,265,122,0.460377358491,0.622950819672,46,0.17358490566,76,0.28679245283
bill_installment,398,259,132,0.509652509653,0.606060606061,52,0.200772200772,80,0.30888030888
bill_installment,399,280,135,0.482142857143,0.614814814815,52,0.185714285714,83,0.296428571429
bill_installment,400,279,126,0.451612903226,0.52380952381,60,0.215053763441,66,0.236559139785
bill_installment,401,275,140,0.509090909091,0.628571428571,52,0.189090909091,88,0.32
bill_installment,402,276,138,0.5,0.594202898551,56,0.202898550725,82,0.297101449275
bill_installment,403,243,120,0.493827160494,0.591666666667,49,0.201646090535,71,0.292181069959
bill_installment,404,251,105,0.418326693227,0.6,42,0.167330677291,63,0.250996015936
bill_installment,405,250,111,0.444,0.630630630631,41,0.164,70,0.28
bill_installment,406,239,120,0.502092050209,0.666666666667,40,0.167364016736,80,0.334728033473
bill_installment,407,219,97,0.442922374429,0.680412371134,31,0.141552511416,66,0.301369863014
bill_installment,408,250,124,0.496,0.629032258065,46,0.184,78,0.312
bill_installment,409,252,121,0.480158730159,0.537190082645,56,0.222222222222,65,0.257936507937
bill_installment,410,241,120,0.497925311203,0.666666666667,40,0.165975103734,80,0.331950207469
bill_installment,411,228,92,0.40350877193,0.663043478261,31,0.135964912281,61,0.267543859649
bill_installment,412,244,115,0.47131147541,0.591304347826,47,0.19262295082,68,0.27868852459
bill_installment,413,216,109,0.50462962963,0.651376146789,38,0.175925925926,71,0.328703703704
bill_installment,414,235,116,0.493617021277,0.620689655172,44,0.187234042553,72,0.306382978723
bill_installment,415,267,118,0.441947565543,0.64406779661,42,0.157303370787,76,0.284644194757
bill_installment,416,242,108,0.446280991736,0.648148148148,38,0.157024793388,70,0.289256198347
bill_installment,417,241,108,0.448132780083,0.685185185185,34,0.141078838174,74,0.307053941909
bill_installment,418,267,117,0.438202247191,0.649572649573,41,0.153558052434,76,0.284644194757
bill_installment,419,225,102,0.453333333333,0.578431372549,43,0.191111111111,59,0.262222222222
bill_installment,420,258,114,0.441860465116,0.605263157895,45,0.174418604651,69,0.267441860465
bill_installment,421,221,96,0.434389140271,0.71875,27,0.122171945701,69,0.31221719457
bill_installment,422,232,103,0.443965517241,0.68932038835,32,0.137931034483,71,0.306034482759
bill_installment,423,208,97,0.466346153846,0.60824742268,38,0.182692307692,59,0.283653846154
bill_installment,424,245,109,0.444897959184,0.605504587156,43,0.175510204082,66,0.269387755102
bill_installment,425,207,106,0.512077294686,0.575471698113,45,0.217391304348,61,0.294685990338
bill_installment,426,218,101,0.463302752294,0.762376237624,24,0.110091743119,77,0.353211009174
bill_installment,427,207,99,0.478260869565,0.666666666667,33,0.159420289855,66,0.31884057971
bill_installment,428,234,111,0.474358974359,0.594594594595,45,0.192307692308,66,0.282051282051
bill_installment,429,196,89,0.454081632653,0.685393258427,28,0.142857142857,61,0.311224489796
bill_installment,430,205,77,0.375609756098,0.662337662338,26,0.126829268293,51,0.248780487805
bill_installment,431,234,115,0.491452991453,0.573913043478,49,0.209401709402,66,0.282051282051
bill_installment,432,222,104,0.468468468468,0.75,26,0.117117117117,78,0.351351351351
bill_installment,433,231,85,0.367965367965,0.717647058824,24,0.103896103896,61,0.264069264069
bill_installment,434,201,100,0.497512437811,0.56,44,0.218905472637,56,0.278606965174
bill_installment,435,201,92,0.457711442786,0.652173913043,32,0.1592039801,60,0.298507462687
bill_installment,436,212,97,0.457547169811,0.536082474227,45,0.212264150943,52,0.245283018868
bill_installment,437,207,105,0.507246376812,0.571428571429,45,0.217391304348,60,0.289855072464
bill_installment,438,195,96,0.492307692308,0.625,36,0.184615384615,60,0.307692307692
bill_installment,439,215,114,0.53023255814,0.701754385965,34,0.158139534884,80,0.372093023256
bill_installment,440,219,108,0.493150684932,0.62037037037,41,0.187214611872,67,0.305936073059
bill_installment,441,186,97,0.521505376344,0.721649484536,27,0.145161290323,70,0.376344086022
bill_installment,442,179,71,0.396648044693,0.619718309859,27,0.150837988827,44,0.245810055866
bill_installment,443,165,93,0.563636363636,0.623655913978,35,0.212121212121,58,0.351515151515
bill_installment,444,204,94,0.460784313725,0.595744680851,38,0.186274509804,56,0.274509803922
bill_installment,445,192,79,0.411458333333,0.708860759494,23,0.119791666667,56,0.291666666667
bill_installment,446,214,98,0.457943925234,0.65306122449,34,0.158878504673,64,0.299065420561
bill_installment,447,206,106,0.514563106796,0.650943396226,37,0.179611650485,69,0.334951456311
bill_installment,448,214,94,0.439252336449,0.723404255319,26,0.121495327103,68,0.317757009346
bill_installment,449,189,95,0.502645502646,0.673684210526,31,0.164021164021,64,0.338624338624
bill_installment,450,191,96,0.502617801047,0.666666666667,32,0.167539267016,64,0.335078534031
bill_installment,451,182,90,0.494505494505,0.666666666667,30,0.164835164835,60,0.32967032967
bill_installment,452,161,78,0.484472049689,0.730769230769,21,0.130434782609,57,0.354037267081
bill_installment,453,155,73,0.470967741935,0.712328767123,21,0.135483870968,52,0.335483870968
bill_installment,454,195,87,0.446153846154,0.64367816092,31,0.158974358974,56,0.287179487179
bill_installment,455,182,99,0.543956043956,0.727272727273,27,0.148351648352,72,0.395604395604
bill_installment,456,170,73,0.429411764706,0.712328767123,21,0.123529411765,52,0.305882352941
bill_installment,457,182,80,0.43956043956,0.6875,25,0.137362637363,55,0.302197802198
bill_installment,458,178,83,0.466292134831,0.650602409639,29,0.162921348315,54,0.303370786517
bill_installment,459,182,93,0.510989010989,0.677419354839,30,0.164835164835,63,0.346153846154
bill_installment,460,165,83,0.50303030303,0.590361445783,34,0.206060606061,49,0.29696969697
bill_installment,461,200,98,0.49,0.622448979592,37,0.185,61,0.305
bill_installment,462,191,95,0.497382198953,0.663157894737,32,0.167539267016,63,0.329842931937
bill_installment,463,193,98,0.507772020725,0.632653061224,36,0.186528497409,62,0.321243523316
bill_installment,464,197,90,0.456852791878,0.644444444444,32,0.162436548223,58,0.294416243655
bill_installment,465,167,88,0.526946107784,0.727272727273,24,0.14371257485,64,0.383233532934
bill_installment,466,173,90,0.520231213873,0.6,36,0.208092485549,54,0.312138728324
bill_installment,467,145,77,0.531034482759,0.675324675325,25,0.172413793103,52,0.358620689655
bill_installment,468,188,89,0.473404255319,0.674157303371,29,0.154255319149,60,0.31914893617
bill_installment,469,169,75,0.443786982249,0.666666666667,25,0.147928994083,50,0.295857988166
bill_installment,470,169,77,0.455621301775,0.688311688312,24,0.14201183432,53,0.313609467456
bill_installment,471,166,78,0.469879518072,0.628205128205,29,0.174698795181,49,0.295180722892
bill_installment,472,199,83,0.417085427136,0.66265060241,28,0.140703517588,55,0.276381909548
bill_installment,473,170,83,0.488235294118,0.626506024096,31,0.182352941176,52,0.305882352941
bill_installment,474,188,103,0.547872340426,0.669902912621,34,0.18085106383,69,0.367021276596
bill_installment,475,146,73,0.5,0.575342465753,31,0.212328767123,42,0.287671232877
bill_installment,476,161,92,0.571428571429,0.652173913043,32,0.198757763975,60,0.372670807453
bill_installment,477,158,78,0.493670886076,0.551282051282,35,0.221518987342,43,0.272151898734
bill_installment,478,174,83,0.477011494253,0.686746987952,26,0.149425287356,57,0.327586206897
bill_installment,479,161,70,0.434782608696,0.671428571429,23,0.142857142857,47,0.291925465839
bill_installment,480,146,75,0.513698630137,0.733333333333,20,0.13698630137,55,0.376712328767
bill_installment,481,174,83,0.477011494253,0.722891566265,23,0.132183908046,60,0.344827586207
bill_installment,482,145,67,0.462068965517,0.671641791045,22,0.151724137931,45,0.310344827586
bill_installment,483,121,71,0.586776859504,0.704225352113,21,0.173553719008,50,0.413223140496
bill_installment,484,168,93,0.553571428571,0.612903225806,36,0.214285714286,57,0.339285714286
bill_installment,485,153,76,0.496732026144,0.736842105263,20,0.130718954248,56,0.366013071895
bill_installment,486,145,71,0.489655172414,0.676056338028,23,0.158620689655,48,0.331034482759
bill_installment,487,156,73,0.467948717949,0.671232876712,24,0.153846153846,49,0.314102564103
bill_installment,488,147,66,0.448979591837,0.666666666667,22,0.149659863946,44,0.299319727891
bill_installment,489,146,78,0.534246575342,0.602564102564,31,0.212328767123,47,0.321917808219
bill_installment,490,169,83,0.491124260355,0.650602409639,29,0.171597633136,54,0.319526627219
bill_installment,491,146,74,0.506849315068,0.635135135135,27,0.184931506849,47,0.321917808219
bill_installment,492,149,65,0.436241610738,0.646153846154,23,0.154362416107,42,0.281879194631
bill_installment,493,143,68,0.475524475524,0.647058823529,24,0.167832167832,44,0.307692307692
bill_installment,494,129,49,0.37984496124,0.69387755102,15,0.116279069767,34,0.263565891473
bill_installment,495,142,70,0.492957746479,0.742857142857,18,0.12676056338,52,0.366197183099
bill_installment,496,150,86,0.573333333333,0.593023255814,35,0.233333333333,51,0.34
bill_installment,497,139,74,0.532374100719,0.635135135135,27,0.194244604317,47,0.338129496403
bill_installment,498,141,66,0.468085106383,0.621212121212,25,0.177304964539,41,0.290780141844
bill_installment,499,142,73,0.514084507042,0.712328767123,21,0.147887323944,52,0.366197183099
bill_installment,500,171,84,0.491228070175,0.738095238095,22,0.12865497076,62,0.362573099415
bill_installment,501,128,62,0.484375,0.677419354839,20,0.15625,42,0.328125
bill_installment,502,119,51,0.428571428571,0.725490196078,14,0.117647058824,37,0.310924369748
bill_installment,503,129,70,0.542635658915,0.628571428571,26,0.201550387597,44,0.341085271318
bill_installment,504,128,66,0.515625,0.712121212121,19,0.1484375,47,0.3671875
bill_installment,505,137,69,0.503649635036,0.666666666667,23,0.167883211679,46,0.335766423358
bill_installment,506,144,80,0.555555555556,0.7125,23,0.159722222222,57,0.395833333333
bill_installment,507,152,79,0.519736842105,0.73417721519,21,0.138157894737,58,0.381578947368
bill_installment,508,131,59,0.450381679389,0.610169491525,23,0.175572519084,36,0.274809160305
bill_installment,509,127,59,0.464566929134,0.661016949153,20,0.157480314961,39,0.307086614173
bill_installment,510,133,63,0.473684210526,0.619047619048,24,0.18045112782,39,0.293233082707
bill_installment,511,121,65,0.537190082645,0.553846153846,29,0.239669421488,36,0.297520661157
bill_installment,512,126,71,0.563492063492,0.704225352113,21,0.166666666667,50,0.396825396825
bill_installment,513,131,75,0.572519083969,0.546666666667,34,0.259541984733,41,0.312977099237
bill_installment,514,112,52,0.464285714286,0.730769230769,14,0.125,38,0.339285714286
bill_installment,515,133,64,0.481203007519,0.71875,18,0.135338345865,46,0.345864661654
bill_installment,516,122,63,0.516393442623,0.666666666667,21,0.172131147541,42,0.344262295082
bill_installment,517,121,56,0.462809917355,0.678571428571,18,0.148760330579,38,0.314049586777
bill_installment,518,118,58,0.491525423729,0.672413793103,19,0.161016949153,39,0.330508474576
bill_installment,519,114,60,0.526315789474,0.65,21,0.184210526316,39,0.342105263158
bill_installment,520,138,69,0.5,0.579710144928,29,0.210144927536,40,0.289855072464
bill_installment,521,124,59,0.475806451613,0.745762711864,15,0.120967741935,44,0.354838709677
bill_installment,522,117,55,0.470085470085,0.636363636364,20,0.17094017094,35,0.299145299145
bill_installment,523,117,55,0.470085470085,0.6,22,0.188034188034,33,0.282051282051
bill_installment,524,145,66,0.455172413793,0.5,33,0.227586206897,33,0.227586206897
bill_installment,525,88,38,0.431818181818,0.710526315789,11,0.125,27,0.306818181818
bill_installment,526,134,75,0.559701492537,0.693333333333,23,0.171641791045,52,0.388059701493
bill_installment,527,140,75,0.535714285714,0.626666666667,28,0.2,47,0.335714285714
bill_installment,528,130,60,0.461538461538,0.683333333333,19,0.146153846154,41,0.315384615385
bill_installment,529,127,51,0.40157480315,0.627450980392,19,0.149606299213,32,0.251968503937
bill_installment,530,119,55,0.46218487395,0.672727272727,18,0.151260504202,37,0.310924369748
bill_installment,531,115,68,0.591304347826,0.75,17,0.147826086957,51,0.44347826087
bill_installment,532,129,66,0.511627906977,0.621212121212,25,0.193798449612,41,0.317829457364
bill_installment,533,107,58,0.542056074766,0.655172413793,20,0.18691588785,38,0.355140186916
bill_installment,534,118,57,0.483050847458,0.719298245614,16,0.135593220339,41,0.347457627119
bill_installment,535,118,65,0.550847457627,0.738461538462,17,0.14406779661,48,0.406779661017
bill_installment,536,103,58,0.563106796117,0.706896551724,17,0.165048543689,41,0.398058252427
bill_installment,537,112,55,0.491071428571,0.672727272727,18,0.160714285714,37,0.330357142857
bill_installment,538,115,58,0.504347826087,0.603448275862,23,0.2,35,0.304347826087
bill_installment,539,121,54,0.446280991736,0.740740740741,14,0.115702479339,40,0.330578512397
bill_installment,540,120,62,0.516666666667,0.661290322581,21,0.175,41,0.341666666667
bill_installment,541,110,57,0.518181818182,0.684210526316,18,0.163636363636,39,0.354545454545
bill_installment,542,102,53,0.519607843137,0.622641509434,20,0.196078431373,33,0.323529411765
bill_installment,543,138,65,0.471014492754,0.615384615385,25,0.18115942029,40,0.289855072464
bill_installment,544,112,59,0.526785714286,0.627118644068,22,0.196428571429,37,0.330357142857
bill_installment,545,116,63,0.543103448276,0.730158730159,17,0.146551724138,46,0.396551724138
bill_installment,546,111,53,0.477477477477,0.584905660377,22,0.198198198198,31,0.279279279279
bill_installment,547,79,42,0.53164556962,0.642857142857,15,0.189873417722,27,0.341772151899
bill_installment,548,103,58,0.563106796117,0.793103448276,12,0.116504854369,46,0.446601941748
bill_installment,549,106,48,0.452830188679,0.708333333333,14,0.132075471698,34,0.320754716981
bill_installment,550,113,58,0.513274336283,0.603448275862,23,0.203539823009,35,0.309734513274
bill_installment,551,116,61,0.525862068966,0.573770491803,26,0.224137931034,35,0.301724137931
bill_installment,552,119,52,0.436974789916,0.615384615385,20,0.168067226891,32,0.268907563025
bill_installment,553,107,54,0.504672897196,0.703703703704,16,0.14953271028,38,0.355140186916
bill_installment,554,94,56,0.595744680851,0.767857142857,13,0.13829787234,43,0.457446808511
bill_installment,555,98,53,0.540816326531,0.735849056604,14,0.142857142857,39,0.397959183673
bill_installment,556,92,49,0.532608695652,0.714285714286,14,0.152173913043,35,0.380434782609
bill_installment,557,103,54,0.52427184466,0.851851851852,8,0.0776699029126,46,0.446601941748
bill_installment,558,82,40,0.487804878049,0.85,6,0.0731707317073,34,0.414634146341
bill_installment,559,106,43,0.405660377358,0.744186046512,11,0.103773584906,32,0.301886792453
bill_installment,560,93,48,0.516129032258,0.708333333333,14,0.150537634409,34,0.365591397849
bill_installment,561,102,58,0.56862745098,0.655172413793,20,0.196078431373,38,0.372549019608
bill_installment,562,99,47,0.474747474747,0.617021276596,18,0.181818181818,29,0.292929292929
bill_installment,563,115,60,0.521739130435,0.616666666667,23,0.2,37,0.321739130435
bill_installment,564,97,45,0.463917525773,0.6,18,0.185567010309,27,0.278350515464
bill_installment,565,88,47,0.534090909091,0.574468085106,20,0.227272727273,27,0.306818181818
bill_installment,566,88,42,0.477272727273,0.690476190476,13,0.147727272727,29,0.329545454545
bill_installment,567,95,54,0.568421052632,0.666666666667,18,0.189473684211,36,0.378947368421
bill_installment,568,95,35,0.368421052632,0.771428571429,8,0.0842105263158,27,0.284210526316
bill_installment,569,88,51,0.579545454545,0.56862745098,22,0.25,29,0.329545454545
bill_installment,570,98,52,0.530612244898,0.692307692308,16,0.163265306122,36,0.367346938776
bill_installment,571,96,53,0.552083333333,0.792452830189,11,0.114583333333,42,0.4375
bill_installment,572,94,49,0.521276595745,0.795918367347,10,0.106382978723,39,0.414893617021
bill_installment,573,92,41,0.445652173913,0.682926829268,13,0.141304347826,28,0.304347826087
bill_installment,574,81,42,0.518518518519,0.714285714286,12,0.148148148148,30,0.37037037037
bill_installment,575,83,54,0.650602409639,0.740740740741,14,0.168674698795,40,0.481927710843
bill_installment,576,75,42,0.56,0.690476190476,13,0.173333333333,29,0.386666666667
bill_installment,577,93,50,0.537634408602,0.74,13,0.139784946237,37,0.397849462366
bill_installment,578,95,48,0.505263157895,0.6875,15,0.157894736842,33,0.347368421053
bill_installment,579,88,43,0.488636363636,0.697674418605,13,0.147727272727,30,0.340909090909
bill_installment,580,89,56,0.629213483146,0.678571428571,18,0.202247191011,38,0.426966292135
bill_installment,581,96,49,0.510416666667,0.632653061224,18,0.1875,31,0.322916666667
bill_installment,582,80,43,0.5375,0.744186046512,11,0.1375,32,0.4
bill_installment,583,82,49,0.59756097561,0.714285714286,14,0.170731707317,35,0.426829268293
bill_installment,584,84,38,0.452380952381,0.710526315789,11,0.130952380952,27,0.321428571429
bill_installment,585,88,43,0.488636363636,0.651162790698,15,0.170454545455,28,0.318181818182
bill_installment,586,74,45,0.608108108108,0.666666666667,15,0.202702702703,30,0.405405405405
bill_installment,587,91,40,0.43956043956,0.7,12,0.131868131868,28,0.307692307692
bill_installment,588,87,41,0.471264367816,0.756097560976,10,0.114942528736,31,0.35632183908
bill_installment,589,79,40,0.506329113924,0.65,14,0.177215189873,26,0.329113924051
bill_installment,590,88,41,0.465909090909,0.756097560976,10,0.113636363636,31,0.352272727273
bill_installment,591,98,49,0.5,0.69387755102,15,0.15306122449,34,0.34693877551
bill_installment,592,97,46,0.474226804124,0.717391304348,13,0.134020618557,33,0.340206185567
bill_installment,593,85,40,0.470588235294,0.7,12,0.141176470588,28,0.329411764706
bill_installment,594,84,41,0.488095238095,0.609756097561,16,0.190476190476,25,0.297619047619
bill_installment,595,83,39,0.469879518072,0.717948717949,11,0.132530120482,28,0.33734939759
bill_installment,596,76,36,0.473684210526,0.722222222222,10,0.131578947368,26,0.342105263158
bill_installment,597,106,57,0.537735849057,0.789473684211,12,0.11320754717,45,0.424528301887
bill_installment,598,95,46,0.484210526316,0.782608695652,10,0.105263157895,36,0.378947368421
bill_installment,599,94,44,0.468085106383,0.636363636364,16,0.170212765957,28,0.297872340426
bill_installment,600,79,40,0.506329113924,0.625,15,0.189873417722,25,0.316455696203
bill_installment,601,90,48,0.533333333333,0.583333333333,20,0.222222222222,28,0.311111111111
bill_installment,602,76,43,0.565789473684,0.674418604651,14,0.184210526316,29,0.381578947368
bill_installment,603,79,43,0.544303797468,0.627906976744,16,0.20253164557,27,0.341772151899
bill_installment,604,85,43,0.505882352941,0.604651162791,17,0.2,26,0.305882352941
bill_installment,605,88,49,0.556818181818,0.65306122449,17,0.193181818182,32,0.363636363636
bill_installment,606,92,46,0.5,0.695652173913,14,0.152173913043,32,0.347826086957
bill_installment,607,75,38,0.506666666667,0.710526315789,11,0.146666666667,27,0.36
bill_installment,608,93,48,0.516129032258,0.604166666667,19,0.204301075269,29,0.311827956989
bill_installment,609,74,32,0.432432432432,0.71875,9,0.121621621622,23,0.310810810811
bill_installment,610,82,46,0.560975609756,0.586956521739,19,0.231707317073,27,0.329268292683
bill_installment,611,68,35,0.514705882353,0.771428571429,8,0.117647058824,27,0.397058823529
bill_installment,612,65,31,0.476923076923,0.741935483871,8,0.123076923077,23,0.353846153846
bill_installment,613,80,41,0.5125,0.682926829268,13,0.1625,28,0.35
bill_installment,614,69,36,0.521739130435,0.722222222222,10,0.144927536232,26,0.376811594203
bill_installment,615,76,37,0.486842105263,0.702702702703,11,0.144736842105,26,0.342105263158
bill_installment,616,59,34,0.576271186441,0.617647058824,13,0.220338983051,21,0.35593220339
bill_installment,617,70,45,0.642857142857,0.511111111111,22,0.314285714286,23,0.328571428571
bill_installment,618,53,27,0.509433962264,0.555555555556,12,0.22641509434,15,0.283018867925
bill_installment,619,74,44,0.594594594595,0.590909090909,18,0.243243243243,26,0.351351351351
bill_installment,620,65,30,0.461538461538,0.7,9,0.138461538462,21,0.323076923077
bill_installment,621,72,42,0.583333333333,0.714285714286,12,0.166666666667,30,0.416666666667
bill_installment,622,70,32,0.457142857143,0.65625,11,0.157142857143,21,0.3
bill_installment,623,68,39,0.573529411765,0.846153846154,6,0.0882352941176,33,0.485294117647
bill_installment,624,82,46,0.560975609756,0.652173913043,16,0.19512195122,30,0.365853658537
bill_installment,625,61,37,0.606557377049,0.648648648649,13,0.213114754098,24,0.393442622951
bill_installment,626,69,36,0.521739130435,0.666666666667,12,0.173913043478,24,0.347826086957
bill_installment,627,79,41,0.518987341772,0.585365853659,17,0.215189873418,24,0.303797468354
bill_installment,628,73,39,0.534246575342,0.692307692308,12,0.164383561644,27,0.369863013699
bill_installment,629,57,27,0.473684210526,0.703703703704,8,0.140350877193,19,0.333333333333
bill_installment,630,84,48,0.571428571429,0.645833333333,17,0.202380952381,31,0.369047619048
bill_installment,631,68,34,0.5,0.588235294118,14,0.205882352941,20,0.294117647059
bill_installment,632,76,42,0.552631578947,0.52380952381,20,0.263157894737,22,0.289473684211
bill_installment,633,72,36,0.5,0.75,9,0.125,27,0.375
bill_installment,634,57,31,0.543859649123,0.612903225806,12,0.210526315789,19,0.333333333333
bill_installment,635,67,31,0.462686567164,0.677419354839,10,0.149253731343,21,0.313432835821
bill_installment,636,69,42,0.608695652174,0.738095238095,11,0.159420289855,31,0.449275362319
bill_installment,637,61,34,0.55737704918,0.705882352941,10,0.16393442623,24,0.393442622951
bill_installment,638,60,32,0.533333333333,0.75,8,0.133333333333,24,0.4
bill_installment,639,70,37,0.528571428571,0.675675675676,12,0.171428571429,25,0.357142857143
bill_installment,640,65,35,0.538461538462,0.771428571429,8,0.123076923077,27,0.415384615385
bill_installment,641,56,26,0.464285714286,0.692307692308,8,0.142857142857,18,0.321428571429
bill_installment,642,83,41,0.493975903614,0.780487804878,9,0.10843373494,32,0.385542168675
bill_installment,643,75,39,0.52,0.692307692308,12,0.16,27,0.36
bill_installment,644,64,30,0.46875,0.6,12,0.1875,18,0.28125
bill_installment,645,71,36,0.507042253521,0.694444444444,11,0.154929577465,25,0.352112676056
bill_installment,646,49,32,0.65306122449,0.75,8,0.163265306122,24,0.489795918367
bill_installment,647,68,35,0.514705882353,0.742857142857,9,0.132352941176,26,0.382352941176
bill_installment,648,75,46,0.613333333333,0.652173913043,16,0.213333333333,30,0.4
bill_installment,649,56,27,0.482142857143,0.666666666667,9,0.160714285714,18,0.321428571429
bill_installment,650,54,25,0.462962962963,0.8,5,0.0925925925926,20,0.37037037037
bill_installment,651,67,34,0.507462686567,0.764705882353,8,0.119402985075,26,0.388059701493
bill_installment,652,54,25,0.462962962963,0.72,7,0.12962962963,18,0.333333333333
bill_installment,653,64,36,0.5625,0.611111111111,14,0.21875,22,0.34375
bill_installment,654,78,43,0.551282051282,0.697674418605,13,0.166666666667,30,0.384615384615
bill_installment,655,68,41,0.602941176471,0.780487804878,9,0.132352941176,32,0.470588235294
bill_installment,656,53,30,0.566037735849,0.6,12,0.22641509434,18,0.339622641509
bill_installment,657,52,30,0.576923076923,0.7,9,0.173076923077,21,0.403846153846
bill_installment,658,55,31,0.563636363636,0.58064516129,13,0.236363636364,18,0.327272727273
bill_installment,659,58,26,0.448275862069,0.615384615385,10,0.172413793103,16,0.275862068966
bill_installment,660,55,26,0.472727272727,0.769230769231,6,0.109090909091,20,0.363636363636
bill_installment,661,54,31,0.574074074074,0.741935483871,8,0.148148148148,23,0.425925925926
bill_installment,662,72,29,0.402777777778,0.655172413793,10,0.138888888889,19,0.263888888889
bill_installment,663,56,27,0.482142857143,0.62962962963,10,0.178571428571,17,0.303571428571
bill_installment,664,61,31,0.508196721311,0.516129032258,15,0.245901639344,16,0.262295081967
bill_installment,665,63,36,0.571428571429,0.666666666667,12,0.190476190476,24,0.380952380952
bill_installment,666,73,31,0.424657534247,0.645161290323,11,0.150684931507,20,0.27397260274
bill_installment,667,54,33,0.611111111111,0.757575757576,8,0.148148148148,25,0.462962962963
bill_installment,668,68,46,0.676470588235,0.565217391304,20,0.294117647059,26,0.382352941176
bill_installment,669,36,17,0.472222222222,0.647058823529,6,0.166666666667,11,0.305555555556
bill_installment,670,56,35,0.625,0.8,7,0.125,28,0.5
bill_installment,671,50,19,0.38,0.842105263158,3,0.06,16,0.32
bill_installment,672,55,24,0.436363636364,0.583333333333,10,0.181818181818,14,0.254545454545
bill_installment,673,52,31,0.596153846154,0.870967741935,4,0.0769230769231,27,0.519230769231
bill_installment,674,64,37,0.578125,0.72972972973,10,0.15625,27,0.421875
bill_installment,675,61,32,0.524590163934,0.75,8,0.131147540984,24,0.393442622951
bill_installment,676,57,33,0.578947368421,0.666666666667,11,0.19298245614,22,0.385964912281
bill_installment,677,50,17,0.34,0.470588235294,9,0.18,8,0.16
bill_installment,678,61,32,0.524590163934,0.6875,10,0.16393442623,22,0.360655737705
bill_installment,679,58,32,0.551724137931,0.625,12,0.206896551724,20,0.344827586207
bill_installment,680,67,28,0.417910447761,0.607142857143,11,0.164179104478,17,0.253731343284
bill_installment,681,54,23,0.425925925926,0.869565217391,3,0.0555555555556,20,0.37037037037
bill_installment,682,48,24,0.5,0.583333333333,10,0.208333333333,14,0.291666666667
bill_installment,683,54,27,0.5,0.555555555556,12,0.222222222222,15,0.277777777778
bill_installment,684,60,26,0.433333333333,0.769230769231,6,0.1,20,0.333333333333
bill_installment,685,67,30,0.44776119403,0.7,9,0.134328358209,21,0.313432835821
bill_installment,686,56,22,0.392857142857,0.636363636364,8,0.142857142857,14,0.25
bill_installment,687,51,23,0.450980392157,0.652173913043,8,0.156862745098,15,0.294117647059
bill_installment,688,60,32,0.533333333333,0.78125,7,0.116666666667,25,0.416666666667
bill_installment,689,54,27,0.5,0.703703703704,8,0.148148148148,19,0.351851851852
bill_installment,690,59,27,0.457627118644,0.592592592593,11,0.186440677966,16,0.271186440678
bill_installment,691,42,25,0.595238095238,0.76,6,0.142857142857,19,0.452380952381
bill_installment,692,54,24,0.444444444444,0.583333333333,10,0.185185185185,14,0.259259259259
bill_installment,693,56,31,0.553571428571,0.58064516129,13,0.232142857143,18,0.321428571429
bill_installment,694,45,26,0.577777777778,0.692307692308,8,0.177777777778,18,0.4
bill_installment,695,50,24,0.48,0.791666666667,5,0.1,19,0.38
bill_installment,696,48,22,0.458333333333,0.772727272727,5,0.104166666667,17,0.354166666667
bill_installment,697,48,26,0.541666666667,0.538461538462,12,0.25,14,0.291666666667
bill_installment,698,49,25,0.510204081633,0.76,6,0.122448979592,19,0.387755102041
bill_installment,699,53,24,0.452830188679,0.666666666667,8,0.150943396226,16,0.301886792453
bill_installment,700,70,38,0.542857142857,0.736842105263,10,0.142857142857,28,0.4
bill_installment,701,48,18,0.375,0.666666666667,6,0.125,12,0.25
bill_installment,702,45,22,0.488888888889,0.545454545455,10,0.222222222222,12,0.266666666667
bill_installment,703,49,25,0.510204081633,0.88,3,0.0612244897959,22,0.448979591837
bill_installment,704,60,33,0.55,0.848484848485,5,0.0833333333333,28,0.466666666667
bill_installment,705,48,29,0.604166666667,0.758620689655,7,0.145833333333,22,0.458333333333
bill_installment,706,47,21,0.446808510638,0.714285714286,6,0.127659574468,15,0.31914893617
bill_installment,707,41,17,0.414634146341,0.764705882353,4,0.0975609756098,13,0.317073170732
bill_installment,708,41,18,0.439024390244,0.444444444444,10,0.243902439024,8,0.19512195122
bill_installment,709,39,20,0.512820512821,0.65,7,0.179487179487,13,0.333333333333
bill_installment,710,56,31,0.553571428571,0.741935483871,8,0.142857142857,23,0.410714285714
bill_installment,711,51,23,0.450980392157,0.739130434783,6,0.117647058824,17,0.333333333333
bill_installment,712,50,28,0.56,0.678571428571,9,0.18,19,0.38
bill_installment,713,38,21,0.552631578947,0.952380952381,1,0.0263157894737,20,0.526315789474
bill_installment,714,44,23,0.522727272727,0.652173913043,8,0.181818181818,15,0.340909090909
bill_installment,715,45,27,0.6,0.703703703704,8,0.177777777778,19,0.422222222222
bill_installment,716,37,18,0.486486486486,0.666666666667,6,0.162162162162,12,0.324324324324
bill_installment,717,52,24,0.461538461538,0.666666666667,8,0.153846153846,16,0.307692307692
bill_installment,718,45,28,0.622222222222,0.678571428571,9,0.2,19,0.422222222222
bill_installment,719,38,24,0.631578947368,0.541666666667,11,0.289473684211,13,0.342105263158
bill_installment,720,49,27,0.551020408163,0.703703703704,8,0.163265306122,19,0.387755102041
bill_installment,721,37,20,0.540540540541,0.8,4,0.108108108108,16,0.432432432432
bill_installment,722,40,17,0.425,0.705882352941,5,0.125,12,0.3
bill_installment,723,51,22,0.43137254902,0.636363636364,8,0.156862745098,14,0.274509803922
bill_installment,724,38,23,0.605263157895,0.782608695652,5,0.131578947368,18,0.473684210526
bill_installment,725,36,21,0.583333333333,0.52380952381,10,0.277777777778,11,0.305555555556
bill_installment,726,38,17,0.447368421053,0.705882352941,5,0.131578947368,12,0.315789473684
bill_installment,727,47,23,0.489361702128,0.826086956522,4,0.0851063829787,19,0.404255319149
bill_installment,728,50,27,0.54,0.62962962963,10,0.2,17,0.34
bill_installment,729,45,20,0.444444444444,0.55,9,0.2,11,0.244444444444
bill_installment,730,40,16,0.4,0.6875,5,0.125,11,0.275
bill_installment,731,41,20,0.487804878049,0.75,5,0.121951219512,15,0.365853658537
bill_installment,732,52,27,0.519230769231,0.777777777778,6,0.115384615385,21,0.403846153846
bill_installment,733,48,28,0.583333333333,0.714285714286,8,0.166666666667,20,0.416666666667
bill_installment,734,41,22,0.536585365854,0.863636363636,3,0.0731707317073,19,0.463414634146
bill_installment,735,47,27,0.574468085106,0.814814814815,5,0.106382978723,22,0.468085106383
bill_installment,736,36,19,0.527777777778,0.631578947368,7,0.194444444444,12,0.333333333333
bill_installment,737,44,23,0.522727272727,0.608695652174,9,0.204545454545,14,0.318181818182
bill_installment,738,41,20,0.487804878049,0.8,4,0.0975609756098,16,0.390243902439
bill_installment,739,42,18,0.428571428571,0.722222222222,5,0.119047619048,13,0.309523809524
bill_installment,740,30,13,0.433333333333,0.769230769231,3,0.1,10,0.333333333333
bill_installment,741,38,20,0.526315789474,0.85,3,0.0789473684211,17,0.447368421053
bill_installment,742,34,21,0.617647058824,0.714285714286,6,0.176470588235,15,0.441176470588
bill_installment,743,37,18,0.486486486486,0.722222222222,5,0.135135135135,13,0.351351351351
bill_installment,744,37,19,0.513513513514,0.684210526316,6,0.162162162162,13,0.351351351351
bill_installment,745,54,32,0.592592592593,0.625,12,0.222222222222,20,0.37037037037
bill_installment,746,32,20,0.625,0.65,7,0.21875,13,0.40625
bill_installment,747,51,25,0.490196078431,0.88,3,0.0588235294118,22,0.43137254902
bill_installment,748,50,23,0.46,0.739130434783,6,0.12,17,0.34
bill_installment,749,39,21,0.538461538462,0.809523809524,4,0.102564102564,17,0.435897435897
bill_installment,750,38,26,0.684210526316,0.769230769231,6,0.157894736842,20,0.526315789474
bill_installment,751,43,24,0.558139534884,0.583333333333,10,0.232558139535,14,0.325581395349
bill_installment,752,35,19,0.542857142857,0.842105263158,3,0.0857142857143,16,0.457142857143
bill_installment,753,35,17,0.485714285714,0.705882352941,5,0.142857142857,12,0.342857142857
bill_installment,754,51,22,0.43137254902,0.636363636364,8,0.156862745098,14,0.274509803922
bill_installment,755,48,27,0.5625,0.481481481481,14,0.291666666667,13,0.270833333333
bill_installment,756,34,18,0.529411764706,0.666666666667,6,0.176470588235,12,0.352941176471
bill_installment,757,26,16,0.615384615385,0.8125,3,0.115384615385,13,0.5
bill_installment,758,44,27,0.613636363636,0.703703703704,8,0.181818181818,19,0.431818181818
bill_installment,759,40,21,0.525,0.52380952381,10,0.25,11,0.275
bill_installment,760,36,17,0.472222222222,0.882352941176,2,0.0555555555556,15,0.416666666667
bill_installment,761,46,25,0.54347826087,0.72,7,0.152173913043,18,0.391304347826
bill_installment,762,30,8,0.266666666667,0.625,3,0.1,5,0.166666666667
bill_installment,763,34,15,0.441176470588,0.6,6,0.176470588235,9,0.264705882353
bill_installment,764,33,18,0.545454545455,0.888888888889,2,0.0606060606061,16,0.484848484848
bill_installment,765,40,18,0.45,0.833333333333,3,0.075,15,0.375
bill_installment,766,29,11,0.379310344828,0.818181818182,2,0.0689655172414,9,0.310344827586
bill_installment,767,31,13,0.41935483871,0.769230769231,3,0.0967741935484,10,0.322580645161
bill_installment,768,31,16,0.516129032258,0.75,4,0.129032258065,12,0.387096774194
bill_installment,769,38,24,0.631578947368,0.75,6,0.157894736842,18,0.473684210526
bill_installment,770,39,14,0.358974358974,0.642857142857,5,0.128205128205,9,0.230769230769
bill_installment,771,39,21,0.538461538462,0.761904761905,5,0.128205128205,16,0.410256410256
bill_installment,772,38,25,0.657894736842,0.56,11,0.289473684211,14,0.368421052632
bill_installment,773,34,18,0.529411764706,0.833333333333,3,0.0882352941176,15,0.441176470588
bill_installment,774,34,19,0.558823529412,0.684210526316,6,0.176470588235,13,0.382352941176
bill_installment,775,37,19,0.513513513514,0.736842105263,5,0.135135135135,14,0.378378378378
bill_installment,776,42,24,0.571428571429,0.666666666667,8,0.190476190476,16,0.380952380952
bill_installment,777,28,16,0.571428571429,0.625,6,0.214285714286,10,0.357142857143
bill_installment,778,40,21,0.525,0.666666666667,7,0.175,14,0.35
bill_installment,779,38,22,0.578947368421,0.727272727273,6,0.157894736842,16,0.421052631579
bill_installment,780,33,19,0.575757575758,0.842105263158,3,0.0909090909091,16,0.484848484848
bill_installment,781,35,20,0.571428571429,0.8,4,0.114285714286,16,0.457142857143
bill_installment,782,36,20,0.555555555556,0.65,7,0.194444444444,13,0.361111111111
bill_installment,783,39,22,0.564102564103,0.681818181818,7,0.179487179487,15,0.384615384615
bill_installment,784,35,18,0.514285714286,0.888888888889,2,0.0571428571429,16,0.457142857143
bill_installment,785,23,17,0.739130434783,0.823529411765,3,0.130434782609,14,0.608695652174
bill_installment,786,28,16,0.571428571429,0.6875,5,0.178571428571,11,0.392857142857
bill_installment,787,24,12,0.5,0.916666666667,1,0.0416666666667,11,0.458333333333
bill_installment,788,38,21,0.552631578947,0.761904761905,5,0.131578947368,16,0.421052631579
bill_installment,789,30,19,0.633333333333,0.631578947368,7,0.233333333333,12,0.4
bill_installment,790,30,13,0.433333333333,0.692307692308,4,0.133333333333,9,0.3
bill_installment,791,35,22,0.628571428571,0.590909090909,9,0.257142857143,13,0.371428571429
bill_installment,792,38,21,0.552631578947,0.571428571429,9,0.236842105263,12,0.315789473684
bill_installment,793,41,17,0.414634146341,0.764705882353,4,0.0975609756098,13,0.317073170732
bill_installment,794,26,13,0.5,0.846153846154,2,0.0769230769231,11,0.423076923077
bill_installment,795,27,13,0.481481481481,0.615384615385,5,0.185185185185,8,0.296296296296
bill_installment,796,30,14,0.466666666667,0.785714285714,3,0.1,11,0.366666666667
bill_installment,797,30,12,0.4,0.5,6,0.2,6,0.2
bill_installment,798,32,22,0.6875,0.636363636364,8,0.25,14,0.4375
bill_installment,799,30,20,0.666666666667,0.75,5,0.166666666667,15,0.5
bill_installment,800,33,15,0.454545454545,0.733333333333,4,0.121212121212,11,0.333333333333
bill_installment,801,31,20,0.645161290323,0.8,4,0.129032258065,16,0.516129032258
bill_installment,802,38,25,0.657894736842,0.68,8,0.210526315789,17,0.447368421053
bill_installment,803,31,16,0.516129032258,0.75,4,0.129032258065,12,0.387096774194
bill_installment,804,39,23,0.589743589744,0.608695652174,9,0.230769230769,14,0.358974358974
bill_installment,805,32,21,0.65625,0.666666666667,7,0.21875,14,0.4375
bill_installment,806,30,15,0.5,0.6,6,0.2,9,0.3
bill_installment,807,29,15,0.51724137931,0.866666666667,2,0.0689655172414,13,0.448275862069
bill_installment,808,31,13,0.41935483871,0.769230769231,3,0.0967741935484,10,0.322580645161
bill_installment,809,28,11,0.392857142857,0.727272727273,3,0.107142857143,8,0.285714285714
bill_installment,810,24,11,0.458333333333,0.727272727273,3,0.125,8,0.333333333333
bill_installment,811,34,21,0.617647058824,0.904761904762,2,0.0588235294118,19,0.558823529412
bill_installment,812,34,18,0.529411764706,0.666666666667,6,0.176470588235,12,0.352941176471
bill_installment,813,28,16,0.571428571429,0.625,6,0.214285714286,10,0.357142857143
bill_installment,814,30,20,0.666666666667,0.75,5,0.166666666667,15,0.5
bill_installment,815,31,15,0.483870967742,0.733333333333,4,0.129032258065,11,0.354838709677
bill_installment,816,36,26,0.722222222222,0.807692307692,5,0.138888888889,21,0.583333333333
bill_installment,817,35,17,0.485714285714,0.823529411765,3,0.0857142857143,14,0.4
bill_installment,818,32,20,0.625,0.6,8,0.25,12,0.375
bill_installment,819,38,16,0.421052631579,0.6875,5,0.131578947368,11,0.289473684211
bill_installment,820,29,14,0.48275862069,0.428571428571,8,0.275862068966,6,0.206896551724
bill_installment,821,31,20,0.645161290323,0.6,8,0.258064516129,12,0.387096774194
bill_installment,822,28,13,0.464285714286,0.692307692308,4,0.142857142857,9,0.321428571429
bill_installment,823,30,15,0.5,0.8,3,0.1,12,0.4
bill_installment,824,30,15,0.5,0.733333333333,4,0.133333333333,11,0.366666666667
bill_installment,825,27,14,0.518518518519,0.5,7,0.259259259259,7,0.259259259259
bill_installment,826,31,21,0.677419354839,0.666666666667,7,0.225806451613,14,0.451612903226
bill_installment,827,26,12,0.461538461538,0.833333333333,2,0.0769230769231,10,0.384615384615
bill_installment,828,29,17,0.586206896552,0.705882352941,5,0.172413793103,12,0.413793103448
bill_installment,829,34,23,0.676470588235,0.739130434783,6,0.176470588235,17,0.5
bill_installment,830,30,21,0.7,0.904761904762,2,0.0666666666667,19,0.633333333333
bill_installment,831,33,19,0.575757575758,0.684210526316,6,0.181818181818,13,0.393939393939
bill_installment,832,34,18,0.529411764706,0.722222222222,5,0.147058823529,13,0.382352941176
bill_installment,833,26,15,0.576923076923,0.8,3,0.115384615385,12,0.461538461538
bill_installment,834,28,17,0.607142857143,0.647058823529,6,0.214285714286,11,0.392857142857
bill_installment,835,31,20,0.645161290323,0.75,5,0.161290322581,15,0.483870967742
bill_installment,836,17,9,0.529411764706,0.666666666667,3,0.176470588235,6,0.352941176471
bill_installment,837,26,14,0.538461538462,0.571428571429,6,0.230769230769,8,0.307692307692
bill_installment,838,29,14,0.48275862069,0.571428571429,6,0.206896551724,8,0.275862068966
bill_installment,839,27,13,0.481481481481,0.692307692308,4,0.148148148148,9,0.333333333333
bill_installment,840,23,14,0.608695652174,0.714285714286,4,0.173913043478,10,0.434782608696
bill_installment,841,31,19,0.612903225806,0.736842105263,5,0.161290322581,14,0.451612903226
bill_installment,842,30,15,0.5,0.866666666667,2,0.0666666666667,13,0.433333333333
bill_installment,843,26,15,0.576923076923,0.4,9,0.346153846154,6,0.230769230769
bill_installment,844,24,12,0.5,0.666666666667,4,0.166666666667,8,0.333333333333
bill_installment,845,24,18,0.75,0.722222222222,5,0.208333333333,13,0.541666666667
bill_installment,846,20,8,0.4,0.75,2,0.1,6,0.3
bill_installment,847,28,12,0.428571428571,0.666666666667,4,0.142857142857,8,0.285714285714
bill_installment,848,29,16,0.551724137931,0.75,4,0.137931034483,12,0.413793103448
bill_installment,849,16,9,0.5625,0.555555555556,4,0.25,5,0.3125
bill_installment,850,22,7,0.318181818182,0.571428571429,3,0.136363636364,4,0.181818181818
bill_installment,851,32,15,0.46875,0.666666666667,5,0.15625,10,0.3125
bill_installment,852,22,13,0.590909090909,0.846153846154,2,0.0909090909091,11,0.5
bill_installment,853,24,14,0.583333333333,0.357142857143,9,0.375,5,0.208333333333
bill_installment,854,25,11,0.44,0.636363636364,4,0.16,7,0.28
bill_installment,855,22,14,0.636363636364,0.642857142857,5,0.227272727273,9,0.409090909091
bill_installment,856,20,15,0.75,0.866666666667,2,0.1,13,0.65
bill_installment,857,26,9,0.346153846154,0.888888888889,1,0.0384615384615,8,0.307692307692
bill_installment,858,26,15,0.576923076923,0.666666666667,5,0.192307692308,10,0.384615384615
bill_installment,859,30,11,0.366666666667,0.545454545455,5,0.166666666667,6,0.2
bill_installment,860,34,18,0.529411764706,0.722222222222,5,0.147058823529,13,0.382352941176
bill_installment,861,30,13,0.433333333333,0.692307692308,4,0.133333333333,9,0.3
bill_installment,862,24,14,0.583333333333,0.928571428571,1,0.0416666666667,13,0.541666666667
bill_installment,863,18,9,0.5,0.555555555556,4,0.222222222222,5,0.277777777778
bill_installment,864,32,16,0.5,0.6875,5,0.15625,11,0.34375
bill_installment,865,28,16,0.571428571429,0.75,4,0.142857142857,12,0.428571428571
bill_installment,866,25,12,0.48,0.916666666667,1,0.04,11,0.44
bill_installment,867,23,16,0.695652173913,0.9375,1,0.0434782608696,15,0.652173913043
bill_installment,868,25,8,0.32,0.75,2,0.08,6,0.24
bill_installment,869,22,12,0.545454545455,0.666666666667,4,0.181818181818,8,0.363636363636
bill_installment,870,22,7,0.318181818182,0.714285714286,2,0.0909090909091,5,0.227272727273
bill_installment,871,21,14,0.666666666667,0.714285714286,4,0.190476190476,10,0.47619047619
bill_installment,872,28,18,0.642857142857,0.666666666667,6,0.214285714286,12,0.428571428571
bill_installment,873,24,11,0.458333333333,0.909090909091,1,0.0416666666667,10,0.416666666667
bill_installment,874,23,8,0.347826086957,0.875,1,0.0434782608696,7,0.304347826087
bill_installment,875,11,5,0.454545454545,0.6,2,0.181818181818,3,0.272727272727
bill_installment,876,22,13,0.590909090909,0.769230769231,3,0.136363636364,10,0.454545454545
bill_installment,877,26,12,0.461538461538,0.833333333333,2,0.0769230769231,10,0.384615384615
bill_installment,878,23,9,0.391304347826,0.666666666667,3,0.130434782609,6,0.260869565217
bill_installment,879,22,15,0.681818181818,0.666666666667,5,0.227272727273,10,0.454545454545
bill_installment,880,25,16,0.64,0.75,4,0.16,12,0.48
bill_installment,881,29,14,0.48275862069,0.642857142857,5,0.172413793103,9,0.310344827586
bill_installment,882,23,13,0.565217391304,0.846153846154,2,0.0869565217391,11,0.478260869565
bill_installment,883,33,14,0.424242424242,0.785714285714,3,0.0909090909091,11,0.333333333333
bill_installment,884,22,10,0.454545454545,0.5,5,0.227272727273,5,0.227272727273
bill_installment,885,27,13,0.481481481481,0.769230769231,3,0.111111111111,10,0.37037037037
bill_installment,886,22,11,0.5,0.636363636364,4,0.181818181818,7,0.318181818182
bill_installment,887,15,9,0.6,0.777777777778,2,0.133333333333,7,0.466666666667
bill_installment,888,21,13,0.619047619048,0.692307692308,4,0.190476190476,9,0.428571428571
bill_installment,889,28,15,0.535714285714,0.733333333333,4,0.142857142857,11,0.392857142857
bill_installment,890,20,10,0.5,0.5,5,0.25,5,0.25
bill_installment,891,30,17,0.566666666667,0.588235294118,7,0.233333333333,10,0.333333333333
bill_installment,892,27,13,0.481481481481,0.692307692308,4,0.148148148148,9,0.333333333333
bill_installment,893,30,20,0.666666666667,0.7,6,0.2,14,0.466666666667
bill_installment,894,24,11,0.458333333333,0.818181818182,2,0.0833333333333,9,0.375
bill_installment,895,20,9,0.45,0.555555555556,4,0.2,5,0.25
bill_installment,896,18,8,0.444444444444,0.875,1,0.0555555555556,7,0.388888888889
bill_installment,897,24,17,0.708333333333,0.823529411765,3,0.125,14,0.583333333333
bill_installment,898,18,9,0.5,0.777777777778,2,0.111111111111,7,0.388888888889
bill_installment,899,24,10,0.416666666667,0.6,4,0.166666666667,6,0.25
bill_installment,900,21,13,0.619047619048,0.615384615385,5,0.238095238095,8,0.380952380952
bill_installment,901,28,16,0.571428571429,0.75,4,0.142857142857,12,0.428571428571
bill_installment,902,22,11,0.5,0.818181818182,2,0.0909090909091,9,0.409090909091
bill_installment,903,20,8,0.4,0.75,2,0.1,6,0.3
bill_installment,904,19,12,0.631578947368,0.75,3,0.157894736842,9,0.473684210526
bill_installment,905,17,6,0.352941176471,0.833333333333,1,0.0588235294118,5,0.294117647059
bill_installment,906,21,15,0.714285714286,0.8,3,0.142857142857,12,0.571428571429
bill_installment,907,21,10,0.47619047619,0.7,3,0.142857142857,7,0.333333333333
bill_installment,908,28,21,0.75,0.714285714286,6,0.214285714286,15,0.535714285714
bill_installment,909,19,10,0.526315789474,0.6,4,0.210526315789,6,0.315789473684
bill_installment,910,28,10,0.357142857143,0.7,3,0.107142857143,7,0.25
bill_installment,911,27,14,0.518518518519,0.785714285714,3,0.111111111111,11,0.407407407407
bill_installment,912,22,14,0.636363636364,0.642857142857,5,0.227272727273,9,0.409090909091
bill_installment,913,25,14,0.56,0.785714285714,3,0.12,11,0.44
bill_installment,914,22,14,0.636363636364,0.642857142857,5,0.227272727273,9,0.409090909091
bill_installment,915,23,14,0.608695652174,0.571428571429,6,0.260869565217,8,0.347826086957
bill_installment,916,18,12,0.666666666667,0.666666666667,4,0.222222222222,8,0.444444444444
bill_installment,917,20,14,0.7,0.714285714286,4,0.2,10,0.5
bill_installment,918,22,9,0.409090909091,0.777777777778,2,0.0909090909091,7,0.318181818182
bill_installment,919,18,12,0.666666666667,0.583333333333,5,0.277777777778,7,0.388888888889
bill_installment,920,26,15,0.576923076923,0.933333333333,1,0.0384615384615,14,0.538461538462
bill_installment,921,19,11,0.578947368421,1.0,0,0.0,11,0.578947368421
bill_installment,922,20,12,0.6,0.666666666667,4,0.2,8,0.4
bill_installment,923,20,9,0.45,0.555555555556,4,0.2,5,0.25
bill_installment,924,26,15,0.576923076923,0.8,3,0.115384615385,12,0.461538461538
bill_installment,925,15,10,0.666666666667,0.6,4,0.266666666667,6,0.4
bill_installment,926,25,9,0.36,0.555555555556,4,0.16,5,0.2
bill_installment,927,27,15,0.555555555556,0.6,6,0.222222222222,9,0.333333333333
bill_installment,928,27,12,0.444444444444,0.75,3,0.111111111111,9,0.333333333333
bill_installment,929,21,12,0.571428571429,0.666666666667,4,0.190476190476,8,0.380952380952
bill_installment,930,25,15,0.6,1.0,0,0.0,15,0.6
bill_installment,931,19,14,0.736842105263,0.857142857143,2,0.105263157895,12,0.631578947368
bill_installment,932,20,15,0.75,0.866666666667,2,0.1,13,0.65
bill_installment,933,21,15,0.714285714286,0.666666666667,5,0.238095238095,10,0.47619047619
bill_installment,934,26,14,0.538461538462,0.571428571429,6,0.230769230769,8,0.307692307692
bill_installment,935,15,10,0.666666666667,0.6,4,0.266666666667,6,0.4
bill_installment,936,19,13,0.684210526316,0.769230769231,3,0.157894736842,10,0.526315789474
bill_installment,937,22,16,0.727272727273,0.625,6,0.272727272727,10,0.454545454545
bill_installment,938,17,12,0.705882352941,0.583333333333,5,0.294117647059,7,0.411764705882
bill_installment,939,14,8,0.571428571429,0.875,1,0.0714285714286,7,0.5
bill_installment,940,18,10,0.555555555556,0.7,3,0.166666666667,7,0.388888888889
bill_installment,941,23,15,0.652173913043,0.8,3,0.130434782609,12,0.521739130435
bill_installment,942,12,6,0.5,1.0,0,0.0,6,0.5
bill_installment,943,11,2,0.181818181818,0.5,1,0.0909090909091,1,0.0909090909091
bill_installment,944,15,11,0.733333333333,0.545454545455,5,0.333333333333,6,0.4
bill_installment,945,11,3,0.272727272727,0.666666666667,1,0.0909090909091,2,0.181818181818
bill_installment,946,18,14,0.777777777778,0.714285714286,4,0.222222222222,10,0.555555555556
bill_installment,947,17,8,0.470588235294,0.875,1,0.0588235294118,7,0.411764705882
bill_installment,948,16,9,0.5625,0.666666666667,3,0.1875,6,0.375
bill_installment,949,14,8,0.571428571429,0.875,1,0.0714285714286,7,0.5
bill_installment,950,20,13,0.65,0.769230769231,3,0.15,10,0.5
bill_installment,951,15,5,0.333333333333,0.4,3,0.2,2,0.133333333333
bill_installment,952,24,11,0.458333333333,0.727272727273,3,0.125,8,0.333333333333
bill_installment,953,21,11,0.52380952381,0.727272727273,3,0.142857142857,8,0.380952380952
bill_installment,954,24,16,0.666666666667,0.75,4,0.166666666667,12,0.5
bill_installment,955,14,9,0.642857142857,0.333333333333,6,0.428571428571,3,0.214285714286
bill_installment,956,20,13,0.65,0.846153846154,2,0.1,11,0.55
bill_installment,957,16,5,0.3125,0.4,3,0.1875,2,0.125
bill_installment,958,12,7,0.583333333333,0.571428571429,3,0.25,4,0.333333333333
bill_installment,959,14,9,0.642857142857,0.888888888889,1,0.0714285714286,8,0.571428571429
bill_installment,960,13,9,0.692307692308,0.888888888889,1,0.0769230769231,8,0.615384615385
bill_installment,961,17,7,0.411764705882,0.714285714286,2,0.117647058824,5,0.294117647059
bill_installment,962,11,6,0.545454545455,0.666666666667,2,0.181818181818,4,0.363636363636
bill_installment,963,12,8,0.666666666667,1.0,0,0.0,8,0.666666666667
bill_installment,964,28,11,0.392857142857,1.0,0,0.0,11,0.392857142857
bill_installment,965,21,13,0.619047619048,0.846153846154,2,0.0952380952381,11,0.52380952381
bill_installment,966,16,7,0.4375,0.857142857143,1,0.0625,6,0.375
bill_installment,967,25,7,0.28,0.857142857143,1,0.04,6,0.24
bill_installment,968,17,4,0.235294117647,0.25,3,0.176470588235,1,0.0588235294118
bill_installment,969,22,14,0.636363636364,0.714285714286,4,0.181818181818,10,0.454545454545
bill_installment,970,22,8,0.363636363636,0.875,1,0.0454545454545,7,0.318181818182
bill_installment,971,25,14,0.56,0.642857142857,5,0.2,9,0.36
bill_installment,972,24,16,0.666666666667,0.8125,3,0.125,13,0.541666666667
bill_installment,973,11,6,0.545454545455,0.333333333333,4,0.363636363636,2,0.181818181818
bill_installment,974,15,6,0.4,0.666666666667,2,0.133333333333,4,0.266666666667
bill_installment,975,20,9,0.45,0.555555555556,4,0.2,5,0.25
bill_installment,976,16,9,0.5625,0.666666666667,3,0.1875,6,0.375
bill_installment,977,10,7,0.7,0.714285714286,2,0.2,5,0.5
bill_installment,978,19,10,0.526315789474,0.6,4,0.210526315789,6,0.315789473684
bill_installment,979,11,4,0.363636363636,1.0,0,0.0,4,0.363636363636
bill_installment,980,22,14,0.636363636364,0.642857142857,5,0.227272727273,9,0.409090909091
bill_installment,981,14,8,0.571428571429,0.5,4,0.285714285714,4,0.285714285714
bill_installment,982,16,10,0.625,0.6,4,0.25,6,0.375
bill_installment,983,22,12,0.545454545455,0.75,3,0.136363636364,9,0.409090909091
bill_installment,984,11,3,0.272727272727,0.333333333333,2,0.181818181818,1,0.0909090909091
bill_installment,985,7,6,0.857142857143,0.833333333333,1,0.142857142857,5,0.714285714286
bill_installment,986,21,9,0.428571428571,0.888888888889,1,0.047619047619,8,0.380952380952
bill_installment,987,16,6,0.375,0.833333333333,1,0.0625,5,0.3125
bill_installment,988,15,5,0.333333333333,0.6,2,0.133333333333,3,0.2
bill_installment,989,14,6,0.428571428571,0.666666666667,2,0.142857142857,4,0.285714285714
bill_installment,990,19,12,0.631578947368,0.75,3,0.157894736842,9,0.473684210526
bill_installment,991,9,5,0.555555555556,0.4,3,0.333333333333,2,0.222222222222
bill_installment,992,17,7,0.411764705882,0.857142857143,1,0.0588235294118,6,0.352941176471
bill_installment,993,11,8,0.727272727273,0.625,3,0.272727272727,5,0.454545454545
bill_installment,994,12,8,0.666666666667,0.75,2,0.166666666667,6,0.5
bill_installment,995,14,5,0.357142857143,0.8,1,0.0714285714286,4,0.285714285714
bill_installment,996,16,12,0.75,0.666666666667,4,0.25,8,0.5
bill_installment,997,19,14,0.736842105263,0.714285714286,4,0.210526315789,10,0.526315789474
bill_installment,998,15,8,0.533333333333,0.875,1,0.0666666666667,7,0.466666666667
bill_installment,999,13,10,0.769230769231,0.9,1,0.0769230769231,9,0.692307692308
bill_installment,1000,21,7,0.333333333333,0.571428571429,3,0.142857142857,4,0.190476190476
bill_installment,1001,19,9,0.473684210526,0.666666666667,3,0.157894736842,6,0.315789473684
bill_installment,1002,12,6,0.5,1.0,0,0.0,6,0.5
bill_installment,1003,12,5,0.416666666667,0.8,1,0.0833333333333,4,0.333333333333
bill_installment,1004,14,7,0.5,0.571428571429,3,0.214285714286,4,0.285714285714
bill_installment,1005,19,15,0.789473684211,0.8,3,0.157894736842,12,0.631578947368
bill_installment,1006,14,13,0.928571428571,0.692307692308,4,0.285714285714,9,0.642857142857
bill_installment,1007,15,12,0.8,0.5,6,0.4,6,0.4
bill_installment,1008,9,4,0.444444444444,0.75,1,0.111111111111,3,0.333333333333
bill_installment,1009,24,8,0.333333333333,0.625,3,0.125,5,0.208333333333
bill_installment,1010,13,7,0.538461538462,0.714285714286,2,0.153846153846,5,0.384615384615
bill_installment,1011,17,7,0.411764705882,0.714285714286,2,0.117647058824,5,0.294117647059
bill_installment,1012,15,8,0.533333333333,0.625,3,0.2,5,0.333333333333
bill_installment,1013,13,7,0.538461538462,0.714285714286,2,0.153846153846,5,0.384615384615
bill_installment,1014,21,11,0.52380952381,0.909090909091,1,0.047619047619,10,0.47619047619
bill_installment,1015,11,9,0.818181818182,0.555555555556,4,0.363636363636,5,0.454545454545
bill_installment,1016,15,9,0.6,0.888888888889,1,0.0666666666667,8,0.533333333333
bill_installment,1017,14,11,0.785714285714,0.909090909091,1,0.0714285714286,10,0.714285714286
bill_installment,1018,9,4,0.444444444444,0.75,1,0.111111111111,3,0.333333333333
bill_installment,1019,15,7,0.466666666667,1.0,0,0.0,7,0.466666666667
bill_installment,1020,14,6,0.428571428571,1.0,0,0.0,6,0.428571428571
bill_installment,1021,11,6,0.545454545455,0.666666666667,2,0.181818181818,4,0.363636363636
bill_installment,1022,16,10,0.625,0.8,2,0.125,8,0.5
bill_installment,1023,18,10,0.555555555556,0.6,4,0.222222222222,6,0.333333333333
bill_installment,1024,10,6,0.6,0.833333333333,1,0.1,5,0.5
bill_installment,1025,15,8,0.533333333333,1.0,0,0.0,8,0.533333333333
bill_installment,1026,17,10,0.588235294118,0.7,3,0.176470588235,7,0.411764705882
bill_installment,1027,16,8,0.5,0.75,2,0.125,6,0.375
bill_installment,1028,15,7,0.466666666667,0.714285714286,2,0.133333333333,5,0.333333333333
bill_installment,1029,12,10,0.833333333333,0.6,4,0.333333333333,6,0.5
bill_installment,1030,18,13,0.722222222222,0.461538461538,7,0.388888888889,6,0.333333333333
bill_installment,1031,12,6,0.5,0.333333333333,4,0.333333333333,2,0.166666666667
bill_installment,1032,14,10,0.714285714286,0.9,1,0.0714285714286,9,0.642857142857
bill_installment,1033,8,6,0.75,0.666666666667,2,0.25,4,0.5
bill_installment,1034,19,11,0.578947368421,0.727272727273,3,0.157894736842,8,0.421052631579
bill_installment,1035,8,2,0.25,1.0,0,0.0,2,0.25
bill_installment,1036,16,9,0.5625,0.666666666667,3,0.1875,6,0.375
bill_installment,1037,15,7,0.466666666667,0.714285714286,2,0.133333333333,5,0.333333333333
bill_installment,1038,24,13,0.541666666667,0.615384615385,5,0.208333333333,8,0.333333333333
bill_installment,1039,17,7,0.411764705882,0.571428571429,3,0.176470588235,4,0.235294117647
bill_installment,1040,13,8,0.615384615385,0.75,2,0.153846153846,6,0.461538461538
bill_installment,1041,11,6,0.545454545455,0.333333333333,4,0.363636363636,2,0.181818181818
bill_installment,1042,14,7,0.5,0.857142857143,1,0.0714285714286,6,0.428571428571
bill_installment,1043,8,4,0.5,1.0,0,0.0,4,0.5
bill_installment,1044,13,7,0.538461538462,0.857142857143,1,0.0769230769231,6,0.461538461538
bill_installment,1045,14,7,0.5,0.857142857143,1,0.0714285714286,6,0.428571428571
bill_installment,1046,12,5,0.416666666667,0.6,2,0.166666666667,3,0.25
bill_installment,1047,8,6,0.75,0.833333333333,1,0.125,5,0.625
bill_installment,1048,17,9,0.529411764706,0.666666666667,3,0.176470588235,6,0.352941176471
bill_installment,1049,17,5,0.294117647059,0.8,1,0.0588235294118,4,0.235294117647
bill_installment,1050,16,11,0.6875,0.454545454545,6,0.375,5,0.3125
bill_installment,1051,13,8,0.615384615385,0.5,4,0.307692307692,4,0.307692307692
bill_installment,1052,22,10,0.454545454545,0.9,1,0.0454545454545,9,0.409090909091
bill_installment,1053,11,5,0.454545454545,0.8,1,0.0909090909091,4,0.363636363636
bill_installment,1054,9,6,0.666666666667,0.5,3,0.333333333333,3,0.333333333333
bill_installment,1055,12,7,0.583333333333,0.857142857143,1,0.0833333333333,6,0.5
bill_installment,1056,13,6,0.461538461538,0.833333333333,1,0.0769230769231,5,0.384615384615
bill_installment,1057,16,10,0.625,0.6,4,0.25,6,0.375
bill_installment,1058,14,8,0.571428571429,0.75,2,0.142857142857,6,0.428571428571
bill_installment,1059,11,5,0.454545454545,1.0,0,0.0,5,0.454545454545
bill_installment,1060,21,10,0.47619047619,0.8,2,0.0952380952381,8,0.380952380952
bill_installment,1061,10,5,0.5,0.8,1,0.1,4,0.4
bill_installment,1062,15,6,0.4,0.666666666667,2,0.133333333333,4,0.266666666667
bill_installment,1063,6,3,0.5,1.0,0,0.0,3,0.5
bill_installment,1064,10,7,0.7,0.714285714286,2,0.2,5,0.5
bill_installment,1065,16,9,0.5625,0.888888888889,1,0.0625,8,0.5
bill_installment,1066,11,6,0.545454545455,0.666666666667,2,0.181818181818,4,0.363636363636
bill_installment,1067,9,5,0.555555555556,0.4,3,0.333333333333,2,0.222222222222
bill_installment,1068,13,4,0.307692307692,0.75,1,0.0769230769231,3,0.230769230769
bill_installment,1069,11,8,0.727272727273,0.75,2,0.181818181818,6,0.545454545455
bill_installment,1070,13,7,0.538461538462,0.571428571429,3,0.230769230769,4,0.307692307692
bill_installment,1071,16,10,0.625,0.8,2,0.125,8,0.5
bill_installment,1072,7,2,0.285714285714,0.0,2,0.285714285714,0,0.0
bill_installment,1073,11,9,0.818181818182,0.666666666667,3,0.272727272727,6,0.545454545455
bill_installment,1074,15,8,0.533333333333,0.625,3,0.2,5,0.333333333333
bill_installment,1075,15,6,0.4,0.833333333333,1,0.0666666666667,5,0.333333333333
bill_installment,1076,12,9,0.75,0.888888888889,1,0.0833333333333,8,0.666666666667
bill_installment,1077,11,11,1.0,0.909090909091,1,0.0909090909091,10,0.909090909091
bill_installment,1078,10,7,0.7,0.571428571429,3,0.3,4,0.4
bill_installment,1079,9,6,0.666666666667,1.0,0,0.0,6,0.666666666667
bill_installment,1080,18,8,0.444444444444,0.625,3,0.166666666667,5,0.277777777778
bill_installment,1081,8,5,0.625,0.6,2,0.25,3,0.375
bill_installment,1082,9,6,0.666666666667,0.833333333333,1,0.111111111111,5,0.555555555556
bill_installment,1083,8,3,0.375,0.333333333333,2,0.25,1,0.125
bill_installment,1084,11,6,0.545454545455,0.833333333333,1,0.0909090909091,5,0.454545454545
bill_installment,1085,14,7,0.5,0.571428571429,3,0.214285714286,4,0.285714285714
bill_installment,1086,11,7,0.636363636364,0.714285714286,2,0.181818181818,5,0.454545454545
bill_installment,1087,16,6,0.375,0.333333333333,4,0.25,2,0.125
bill_installment,1088,6,5,0.833333333333,1.0,0,0.0,5,0.833333333333
bill_installment,1089,7,4,0.571428571429,0.75,1,0.142857142857,3,0.428571428571
bill_installment,1090,13,7,0.538461538462,1.0,0,0.0,7,0.538461538462
bill_installment,1091,14,9,0.642857142857,0.777777777778,2,0.142857142857,7,0.5
bill_installment,1092,14,8,0.571428571429,0.75,2,0.142857142857,6,0.428571428571
bill_installment,1093,10,7,0.7,0.857142857143,1,0.1,6,0.6
bill_installment,1094,8,4,0.5,0.25,3,0.375,1,0.125
bill_installment,1095,7,5,0.714285714286,1.0,0,0.0,5,0.714285714286
bill_installment,1096,9,6,0.666666666667,1.0,0,0.0,6,0.666666666667
bill_installment,1097,17,10,0.588235294118,0.6,4,0.235294117647,6,0.352941176471
bill_installment,1098,12,6,0.5,1.0,0,0.0,6,0.5
bill_installment,1099,9,3,0.333333333333,0.333333333333,2,0.222222222222,1,0.111111111111
bill_installment,1100,15,10,0.666666666667,0.8,2,0.133333333333,8,0.533333333333
bill_installment,1101,16,8,0.5,0.875,1,0.0625,7,0.4375
bill_installment,1102,10,7,0.7,0.857142857143,1,0.1,6,0.6
bill_installment,1103,14,8,0.571428571429,0.875,1,0.0714285714286,7,0.5
bill_installment,1104,6,4,0.666666666667,0.5,2,0.333333333333,2,0.333333333333
bill_installment,1105,7,4,0.571428571429,0.5,2,0.285714285714,2,0.285714285714
bill_installment,1106,8,5,0.625,0.8,1,0.125,4,0.5
bill_installment,1107,11,5,0.454545454545,0.8,1,0.0909090909091,4,0.363636363636
bill_installment,1108,13,8,0.615384615385,0.75,2,0.153846153846,6,0.461538461538
bill_installment,1109,9,5,0.555555555556,1.0,0,0.0,5,0.555555555556
bill_installment,1110,10,5,0.5,1.0,0,0.0,5,0.5
bill_installment,1111,13,7,0.538461538462,0.714285714286,2,0.153846153846,5,0.384615384615
bill_installment,1112,11,7,0.636363636364,0.714285714286,2,0.181818181818,5,0.454545454545
bill_installment,1113,9,5,0.555555555556,0.4,3,0.333333333333,2,0.222222222222
bill_installment,1114,14,12,0.857142857143,0.5,6,0.428571428571,6,0.428571428571
bill_installment,1115,10,5,0.5,0.8,1,0.1,4,0.4
bill_installment,1116,5,1,0.2,1.0,0,0.0,1,0.2
bill_installment,1117,12,9,0.75,0.777777777778,2,0.166666666667,7,0.583333333333
bill_installment,1118,13,6,0.461538461538,0.833333333333,1,0.0769230769231,5,0.384615384615
bill_installment,1119,11,4,0.363636363636,0.75,1,0.0909090909091,3,0.272727272727
bill_installment,1120,10,6,0.6,0.833333333333,1,0.1,5,0.5
bill_installment,1121,6,3,0.5,0.333333333333,2,0.333333333333,1,0.166666666667
bill_installment,1122,12,8,0.666666666667,0.625,3,0.25,5,0.416666666667
bill_installment,1123,8,1,0.125,1.0,0,0.0,1,0.125
bill_installment,1124,9,4,0.444444444444,0.25,3,0.333333333333,1,0.111111111111
bill_installment,1125,12,8,0.666666666667,0.625,3,0.25,5,0.416666666667
bill_installment,1126,10,6,0.6,0.333333333333,4,0.4,2,0.2
bill_installment,1127,14,6,0.428571428571,1.0,0,0.0,6,0.428571428571
bill_installment,1128,9,3,0.333333333333,1.0,0,0.0,3,0.333333333333
bill_installment,1129,5,2,0.4,0.5,1,0.2,1,0.2
bill_installment,1130,9,4,0.444444444444,0.75,1,0.111111111111,3,0.333333333333
bill_installment,1131,8,5,0.625,1.0,0,0.0,5,0.625
bill_installment,1132,6,2,0.333333333333,1.0,0,0.0,2,0.333333333333
bill_installment,1133,14,10,0.714285714286,0.9,1,0.0714285714286,9,0.642857142857
bill_installment,1134,12,7,0.583333333333,0.571428571429,3,0.25,4,0.333333333333
bill_installment,1135,17,11,0.647058823529,0.909090909091,1,0.0588235294118,10,0.588235294118
bill_installment,1136,10,6,0.6,0.833333333333,1,0.1,5,0.5
bill_installment,1137,10,6,0.6,0.666666666667,2,0.2,4,0.4
bill_installment,1138,6,1,0.166666666667,1.0,0,0.0,1,0.166666666667
bill_installment,1139,8,4,0.5,0.5,2,0.25,2,0.25
bill_installment,1140,12,7,0.583333333333,0.285714285714,5,0.416666666667,2,0.166666666667
bill_installment,1141,5,1,0.2,1.0,0,0.0,1,0.2
bill_installment,1142,7,3,0.428571428571,0.666666666667,1,0.142857142857,2,0.285714285714
bill_installment,1143,6,3,0.5,1.0,0,0.0,3,0.5
bill_installment,1144,9,5,0.555555555556,0.8,1,0.111111111111,4,0.444444444444
bill_installment,1145,12,9,0.75,0.666666666667,3,0.25,6,0.5
bill_installment,1146,10,6,0.6,0.333333333333,4,0.4,2,0.2
bill_installment,1147,6,3,0.5,1.0,0,0.0,3,0.5
bill_installment,1148,13,7,0.538461538462,0.571428571429,3,0.230769230769,4,0.307692307692
bill_installment,1149,15,8,0.533333333333,0.625,3,0.2,5,0.333333333333
bill_installment,1150,12,5,0.416666666667,1.0,0,0.0,5,0.416666666667
bill_installment,1151,6,2,0.333333333333,0.5,1,0.166666666667,1,0.166666666667
bill_installment,1152,5,0,0.0,NULL,0,0.0,0,0.0
bill_installment,1153,15,8,0.533333333333,0.875,1,0.0666666666667,7,0.466666666667
bill_installment,1154,7,4,0.571428571429,1.0,0,0.0,4,0.571428571429
bill_installment,1155,9,5,0.555555555556,0.8,1,0.111111111111,4,0.444444444444
bill_installment,1156,9,6,0.666666666667,0.833333333333,1,0.111111111111,5,0.555555555556
bill_installment,1157,11,6,0.545454545455,1.0,0,0.0,6,0.545454545455
bill_installment,1158,14,6,0.428571428571,0.833333333333,1,0.0714285714286,5,0.357142857143
bill_installment,1159,6,2,0.333333333333,1.0,0,0.0,2,0.333333333333
bill_installment,1160,10,5,0.5,1.0,0,0.0,5,0.5
bill_installment,1161,7,3,0.428571428571,1.0,0,0.0,3,0.428571428571
bill_installment,1162,9,3,0.333333333333,0.666666666667,1,0.111111111111,2,0.222222222222
bill_installment,1163,8,6,0.75,1.0,0,0.0,6,0.75
bill_installment,1164,9,4,0.444444444444,1.0,0,0.0,4,0.444444444444
bill_installment,1165,11,6,0.545454545455,1.0,0,0.0,6,0.545454545455
bill_installment,1166,6,0,0.0,NULL,0,0.0,0,0.0
bill_installment,1167,7,3,0.428571428571,1.0,0,0.0,3,0.428571428571
bill_installment,1168,14,9,0.642857142857,0.666666666667,3,0.214285714286,6,0.428571428571
bill_installment,1169,5,2,0.4,1.0,0,0.0,2,0.4
bill_installment,1170,6,4,0.666666666667,0.75,1,0.166666666667,3,0.5
bill_installment,1171,11,7,0.636363636364,0.571428571429,3,0.272727272727,4,0.363636363636
bill_installment,1172,5,2,0.4,1.0,0,0.0,2,0.4
bill_installment,1173,12,6,0.5,1.0,0,0.0,6,0.5
bill_installment,1174,1,1,1.0,1.0,0,0.0,1,1.0
bill_installment,1175,7,4,0.571428571429,1.0,0,0.0,4,0.571428571429
bill_installment,1176,9,5,0.555555555556,0.6,2,0.222222222222,3,0.333333333333
bill_installment,1177,4,4,1.0,0.75,1,0.25,3,0.75
bill_installment,1178,11,7,0.636363636364,0.571428571429,3,0.272727272727,4,0.363636363636
bill_installment,1179,14,5,0.357142857143,0.6,2,0.142857142857,3,0.214285714286
bill_installment,1180,7,3,0.428571428571,1.0,0,0.0,3,0.428571428571
bill_installment,1181,6,2,0.333333333333,1.0,0,0.0,2,0.333333333333
bill_installment,1182,13,10,0.769230769231,0.6,4,0.307692307692,6,0.461538461538
bill_installment,1183,8,4,0.5,0.75,1,0.125,3,0.375
bill_installment,1184,11,5,0.454545454545,0.6,2,0.181818181818,3,0.272727272727
bill_installment,1185,11,5,0.454545454545,0.4,3,0.272727272727,2,0.181818181818
bill_installment,1186,8,6,0.75,0.5,3,0.375,3,0.375
bill_installment,1187,6,5,0.833333333333,1.0,0,0.0,5,0.833333333333
bill_installment,1188,14,7,0.5,0.571428571429,3,0.214285714286,4,0.285714285714
bill_installment,1189,10,7,0.7,0.857142857143,1,0.1,6,0.6
bill_installment,1190,6,3,0.5,0.666666666667,1,0.166666666667,2,0.333333333333
bill_installment,1191,9,6,0.666666666667,1.0,0,0.0,6,0.666666666667
bill_installment,1192,6,3,0.5,0.666666666667,1,0.166666666667,2,0.333333333333
bill_installment,1193,11,5,0.454545454545,0.6,2,0.181818181818,3,0.272727272727
bill_installment,1194,4,2,0.5,1.0,0,0.0,2,0.5
bill_installment,1195,9,3,0.333333333333,0.333333333333,2,0.222222222222,1,0.111111111111
bill_installment,1196,12,5,0.416666666667,0.8,1,0.0833333333333,4,0.333333333333
bill_installment,1197,4,1,0.25,1.0,0,0.0,1,0.25
bill_installment,1198,3,2,0.666666666667,1.0,0,0.0,2,0.666666666667
bill_installment,1199,7,4,0.571428571429,0.5,2,0.285714285714,2,0.285714285714
bill_installment,1200,6,3,0.5,1.0,0,0.0,3,0.5
bill_installment,1201,6,3,0.5,0.666666666667,1,0.166666666667,2,0.333333333333
bill_installment,1202,12,8,0.666666666667,0.875,1,0.0833333333333,7,0.583333333333
bill_installment,1203,12,6,0.5,0.833333333333,1,0.0833333333333,5,0.416666666667
bill_installment,1204,9,4,0.444444444444,0.75,1,0.111111111111,3,0.333333333333
bill_installment,1205,7,4,0.571428571429,0.75,1,0.142857142857,3,0.428571428571
bill_installment,1206,11,6,0.545454545455,0.666666666667,2,0.181818181818,4,0.363636363636
bill_installment,1207,6,3,0.5,1.0,0,0.0,3,0.5
bill_installment,1208,5,2,0.4,0.5,1,0.2,1,0.2
bill_installment,1209,9,4,0.444444444444,1.0,0,0.0,4,0.444444444444
bill_installment,1210,8,6,0.75,0.333333333333,4,0.5,2,0.25
bill_installment,1211,11,5,0.454545454545,0.8,1,0.0909090909091,4,0.363636363636
bill_installment,1212,11,7,0.636363636364,0.857142857143,1,0.0909090909091,6,0.545454545455
bill_installment,1213,5,3,0.6,0.333333333333,2,0.4,1,0.2
bill_installment,1214,10,7,0.7,0.571428571429,3,0.3,4,0.4
bill_installment,1215,8,4,0.5,0.75,1,0.125,3,0.375
bill_installment,1216,9,6,0.666666666667,0.833333333333,1,0.111111111111,5,0.555555555556
bill_installment,1217,13,8,0.615384615385,0.625,3,0.230769230769,5,0.384615384615
bill_installment,1218,10,4,0.4,1.0,0,0.0,4,0.4
bill_installment,1219,15,10,0.666666666667,0.9,1,0.0666666666667,9,0.6
bill_installment,1220,7,4,0.571428571429,0.25,3,0.428571428571,1,0.142857142857
bill_installment,1221,8,5,0.625,0.4,3,0.375,2,0.25
bill_installment,1222,10,5,0.5,0.8,1,0.1,4,0.4
bill_installment,1223,8,5,0.625,0.2,4,0.5,1,0.125
bill_installment,1224,16,7,0.4375,0.428571428571,4,0.25,3,0.1875
bill_installment,1225,5,1,0.2,1.0,0,0.0,1,0.2
bill_installment,1226,3,1,0.333333333333,1.0,0,0.0,1,0.333333333333
bill_installment,1227,8,3,0.375,0.333333333333,2,0.25,1,0.125
bill_installment,1228,4,3,0.75,0.666666666667,1,0.25,2,0.5
bill_installment,1229,7,6,0.857142857143,0.833333333333,1,0.142857142857,5,0.714285714286
bill_installment,1230,7,5,0.714285714286,1.0,0,0.0,5,0.714285714286
bill_installment,1231,10,8,0.8,0.75,2,0.2,6,0.6
bill_installment,1232,7,5,0.714285714286,0.8,1,0.142857142857,4,0.571428571429
bill_installment,1233,5,3,0.6,1.0,0,0.0,3,0.6
bill_installment,1234,9,4,0.444444444444,0.75,1,0.111111111111,3,0.333333333333
bill_installment,1235,2,2,1.0,0.5,1,0.5,1,0.5
bill_installment,1236,8,5,0.625,1.0,0,0.0,5,0.625
bill_installment,1237,7,3,0.428571428571,0.333333333333,2,0.285714285714,1,0.142857142857
bill_installment,1238,6,3,0.5,0.333333333333,2,0.333333333333,1,0.166666666667
bill_installment,1239,5,2,0.4,0.0,2,0.4,0,0.0
bill_installment,1240,6,4,0.666666666667,1.0,0,0.0,4,0.666666666667
bill_installment,1241,5,1,0.2,0.0,1,0.2,0,0.0
bill_installment,1242,7,4,0.571428571429,0.75,1,0.142857142857,3,0.428571428571
bill_installment,1243,6,4,0.666666666667,0.75,1,0.166666666667,3,0.5
bill_installment,1244,9,4,0.444444444444,0.75,1,0.111111111111,3,0.333333333333
bill_installment,1245,7,4,0.571428571429,1.0,0,0.0,4,0.571428571429
bill_installment,1246,8,4,0.5,0.75,1,0.125,3,0.375
bill_installment,1247,8,5,0.625,0.6,2,0.25,3,0.375
bill_installment,1248,7,5,0.714285714286,0.8,1,0.142857142857,4,0.571428571429
bill_installment,1249,8,2,0.25,0.0,2,0.25,0,0.0
bill_installment,1250,6,4,0.666666666667,0.75,1,0.166666666667,3,0.5
bill_installment,1251,5,2,0.4,1.0,0,0.0,2,0.4
bill_installment,1252,11,7,0.636363636364,0.714285714286,2,0.181818181818,5,0.454545454545
bill_installment,1253,6,5,0.833333333333,0.2,4,0.666666666667,1,0.166666666667
bill_installment,1254,3,3,1.0,1.0,0,0.0,3,1.0
bill_installment,1255,5,1,0.2,0.0,1,0.2,0,0.0
bill_installment,1256,8,4,0.5,0.75,1,0.125,3,0.375
bill_installment,1257,7,5,0.714285714286,0.8,1,0.142857142857,4,0.571428571429
bill_installment,1258,3,2,0.666666666667,0.5,1,0.333333333333,1,0.333333333333
bill_installment,1259,8,5,0.625,1.0,0,0.0,5,0.625
bill_installment,1260,8,6,0.75,0.833333333333,1,0.125,5,0.625
bill_installment,1261,12,8,0.666666666667,0.875,1,0.0833333333333,7,0.583333333333
bill_installment,1262,9,7,0.777777777778,0.428571428571,4,0.444444444444,3,0.333333333333
bill_installment,1263,6,4,0.666666666667,1.0,0,0.0,4,0.666666666667
bill_installment,1264,5,3,0.6,0.333333333333,2,0.4,1,0.2
bill_installment,1265,12,5,0.416666666667,1.0,0,0.0,5,0.416666666667
bill_installment,1266,7,4,0.571428571429,1.0,0,0.0,4,0.571428571429
bill_installment,1267,10,4,0.4,0.75,1,0.1,3,0.3
bill_installment,1268,7,4,0.571428571429,0.5,2,0.285714285714,2,0.285714285714
bill_installment,1269,5,3,0.6,0.666666666667,1,0.2,2,0.4
bill_installment,1270,7,5,0.714285714286,0.8,1,0.142857142857,4,0.571428571429
bill_installment,1271,3,1,0.333333333333,1.0,0,0.0,1,0.333333333333
bill_installment,1272,5,4,0.8,1.0,0,0.0,4,0.8
bill_installment,1273,7,4,0.571428571429,1.0,0,0.0,4,0.571428571429
bill_installment,1274,3,2,0.666666666667,0.5,1,0.333333333333,1,0.333333333333
bill_installment,1275,5,3,0.6,0.666666666667,1,0.2,2,0.4
bill_installment,1276,6,2,0.333333333333,0.5,1,0.166666666667,1,0.166666666667
bill_installment,1277,3,2,0.666666666667,0.5,1,0.333333333333,1,0.333333333333
bill_installment,1278,6,5,0.833333333333,0.6,2,0.333333333333,3,0.5
bill_installment,1279,6,2,0.333333333333,0.5,1,0.166666666667,1,0.166666666667
bill_installment,1280,8,5,0.625,0.4,3,0.375,2,0.25
bill_installment,1281,6,3,0.5,0.666666666667,1,0.166666666667,2,0.333333333333
bill_installment,1282,6,2,0.333333333333,0.5,1,0.166666666667,1,0.166666666667
bill_installment,1283,6,4,0.666666666667,0.25,3,0.5,1,0.166666666667
bill_installment,1284,8,2,0.25,1.0,0,0.0,2,0.25
bill_installment,1285,9,4,0.444444444444,1.0,0,0.0,4,0.444444444444
bill_installment,1286,3,3,1.0,0.333333333333,2,0.666666666667,1,0.333333333333
bill_installment,1287,5,2,0.4,0.5,1,0.2,1,0.2
bill_installment,1288,8,3,0.375,0.666666666667,1,0.125,2,0.25
bill_installment,1289,5,4,0.8,1.0,0,0.0,4,0.8
bill_installment,1290,6,4,0.666666666667,1.0,0,0.0,4,0.666666666667
bill_installment,1291,6,5,0.833333333333,0.6,2,0.333333333333,3,0.5
bill_installment,1292,10,6,0.6,0.833333333333,1,0.1,5,0.5
bill_installment,1293,4,4,1.0,0.75,1,0.25,3,0.75
bill_installment,1294,4,1,0.25,1.0,0,0.0,1,0.25
bill_installment,1295,2,2,1.0,0.5,1,0.5,1,0.5
bill_installment,1296,6,5,0.833333333333,0.8,1,0.166666666667,4,0.666666666667
bill_installment,1297,7,4,0.571428571429,0.5,2,0.285714285714,2,0.285714285714
bill_installment,1298,2,1,0.5,1.0,0,0.0,1,0.5
bill_installment,1299,7,5,0.714285714286,0.8,1,0.142857142857,4,0.571428571429
bill_installment,1300,7,5,0.714285714286,0.8,1,0.142857142857,4,0.571428571429
bill_installment,1301,4,0,0.0,NULL,0,0.0,0,0.0
bill_installment,1302,4,3,0.75,0.666666666667,1,0.25,2,0.5
bill_installment,1303,6,4,0.666666666667,0.25,3,0.5,1,0.166666666667
bill_installment,1304,9,3,0.333333333333,0.666666666667,1,0.111111111111,2,0.222222222222
bill_installment,1305,8,5,0.625,0.8,1,0.125,4,0.5
bill_installment,1306,1,0,0.0,NULL,0,0.0,0,0.0
bill_installment,1307,4,3,0.75,0.666666666667,1,0.25,2,0.5
bill_installment,1308,9,3,0.333333333333,1.0,0,0.0,3,0.333333333333
bill_installment,1309,3,2,0.666666666667,0.5,1,0.333333333333,1,0.333333333333
bill_installment,1310,10,6,0.6,1.0,0,0.0,6,0.6
bill_installment,1311,5,2,0.4,1.0,0,0.0,2,0.4
bill_installment,1312,7,5,0.714285714286,1.0,0,0.0,5,0.714285714286
bill_installment,1313,6,1,0.166666666667,0.0,1,0.166666666667,0,0.0
bill_installment,1314,6,4,0.666666666667,0.75,1,0.166666666667,3,0.5
bill_installment,1315,6,3,0.5,1.0,0,0.0,3,0.5
bill_installment,1316,5,4,0.8,0.75,1,0.2,3,0.6
bill_installment,1317,6,5,0.833333333333,0.8,1,0.166666666667,4,0.666666666667
bill_installment,1318,6,4,0.666666666667,0.5,2,0.333333333333,2,0.333333333333
bill_installment,1319,6,4,0.666666666667,1.0,0,0.0,4,0.666666666667
bill_installment,1320,4,3,0.75,0.666666666667,1,0.25,2,0.5
bill_installment,1321,7,4,0.571428571429,0.75,1,0.142857142857,3,0.428571428571
bill_installment,1322,5,5,1.0,0.8,1,0.2,4,0.8
bill_installment,1323,7,2,0.285714285714,1.0,0,0.0,2,0.285714285714
bill_installment,1324,7,5,0.714285714286,0.4,3,0.428571428571,2,0.285714285714
bill_installment,1325,7,4,0.571428571429,1.0,0,0.0,4,0.571428571429
bill_installment,1326,4,3,0.75,0.666666666667,1,0.25,2,0.5
bill_installment,1327,4,3,0.75,1.0,0,0.0,3,0.75
bill_installment,1328,1,0,0.0,NULL,0,0.0,0,0.0
bill_installment,1329,4,3,0.75,0.666666666667,1,0.25,2,0.5
bill_installment,1330,4,2,0.5,1.0,0,0.0,2,0.5
bill_installment,1331,9,7,0.777777777778,0.571428571429,3,0.333333333333,4,0.444444444444
bill_installment,1332,11,6,0.545454545455,0.833333333333,1,0.0909090909091,5,0.454545454545
bill_installment,1333,9,5,0.555555555556,0.4,3,0.333333333333,2,0.222222222222
bill_installment,1334,3,2,0.666666666667,1.0,0,0.0,2,0.666666666667
bill_installment,1335,6,4,0.666666666667,1.0,0,0.0,4,0.666666666667
bill_installment,1336,3,2,0.666666666667,0.5,1,0.333333333333,1,0.333333333333
bill_installment,1337,1,1,1.0,1.0,0,0.0,1,1.0
bill_installment,1338,4,1,0.25,1.0,0,0.0,1,0.25
bill_installment,1339,4,3,0.75,1.0,0,0.0,3,0.75
bill_installment,1340,4,2,0.5,0.5,1,0.25,1,0.25
bill_installment,1341,8,5,0.625,0.6,2,0.25,3,0.375
bill_installment,1342,5,5,1.0,0.6,2,0.4,3,0.6
bill_installment,1343,2,2,1.0,1.0,0,0.0,2,1.0
bill_installment,1344,4,3,0.75,1.0,0,0.0,3,0.75
bill_installment,1345,3,1,0.333333333333,0.0,1,0.333333333333,0,0.0
bill_installment,1346,7,6,0.857142857143,0.666666666667,2,0.285714285714,4,0.571428571429
bill_installment,1347,4,3,0.75,1.0,0,0.0,3,0.75
bill_installment,1348,4,1,0.25,0.0,1,0.25,0,0.0
bill_installment,1349,6,5,0.833333333333,0.6,2,0.333333333333,3,0.5
bill_installment,1350,7,3,0.428571428571,1.0,0,0.0,3,0.428571428571
bill_installment,1351,7,6,0.857142857143,0.666666666667,2,0.285714285714,4,0.571428571429
bill_installment,1352,3,3,1.0,0.666666666667,1,0.333333333333,2,0.666666666667
bill_installment,1353,4,2,0.5,1.0,0,0.0,2,0.5
bill_installment,1354,8,5,0.625,0.8,1,0.125,4,0.5
bill_installment,1355,4,3,0.75,0.666666666667,1,0.25,2,0.5
bill_installment,1356,5,4,0.8,0.5,2,0.4,2,0.4
bill_installment,1357,4,2,0.5,0.0,2,0.5,0,0.0
bill_installment,1358,6,5,0.833333333333,0.6,2,0.333333333333,3,0.5
bill_installment,1359,4,3,0.75,1.0,0,0.0,3,0.75
bill_installment,1360,5,3,0.6,1.0,0,0.0,3,0.6
bill_installment,1361,3,2,0.666666666667,1.0,0,0.0,2,0.666666666667
bill_installment,1362,8,5,0.625,1.0,0,0.0,5,0.625
bill_installment,1363,5,3,0.6,0.333333333333,2,0.4,1,0.2
bill_installment,1364,7,4,0.571428571429,1.0,0,0.0,4,0.571428571429
bill_installment,1365,6,3,0.5,0.666666666667,1,0.166666666667,2,0.333333333333
bill_installment,1366,5,2,0.4,0.5,1,0.2,1,0.2
bill_installment,1367,7,3,0.428571428571,0.666666666667,1,0.142857142857,2,0.285714285714
bill_installment,1368,5,3,0.6,0.666666666667,1,0.2,2,0.4
bill_installment,1369,4,2,0.5,1.0,0,0.0,2,0.5
bill_installment,1370,5,4,0.8,0.75,1,0.2,3,0.6
bill_installment,1371,6,3,0.5,0.666666666667,1,0.166666666667,2,0.333333333333
bill_installment,1372,6,1,0.166666666667,0.0,1,0.166666666667,0,0.0
bill_installment,1373,6,4,0.666666666667,1.0,0,0.0,4,0.666666666667
bill_installment,1374,8,8,1.0,0.75,2,0.25,6,0.75
bill_installment,1375,3,1,0.333333333333,1.0,0,0.0,1,0.333333333333
bill_installment,1376,8,4,0.5,1.0,0,0.0,4,0.5
bill_installment,1377,5,3,0.6,1.0,0,0.0,3,0.6
bill_installment,1378,8,3,0.375,0.333333333333,2,0.25,1,0.125
bill_installment,1379,5,5,1.0,1.0,0,0.0,5,1.0
bill_installment,1380,4,3,0.75,0.666666666667,1,0.25,2,0.5
bill_installment,1381,5,3,0.6,0.333333333333,2,0.4,1,0.2
bill_installment,1382,5,2,0.4,0.5,1,0.2,1,0.2
bill_installment,1383,5,2,0.4,1.0,0,0.0,2,0.4
bill_installment,1384,2,2,1.0,0.5,1,0.5,1,0.5
bill_installment,1385,4,2,0.5,1.0,0,0.0,2,0.5
bill_installment,1386,3,2,0.666666666667,1.0,0,0.0,2,0.666666666667
bill_installment,1387,7,5,0.714285714286,0.8,1,0.142857142857,4,0.571428571429
bill_installment,1388,4,4,1.0,1.0,0,0.0,4,1.0
bill_installment,1389,4,1,0.25,1.0,0,0.0,1,0.25
bill_installment,1390,4,2,0.5,1.0,0,0.0,2,0.5
bill_installment,1391,5,3,0.6,0.666666666667,1,0.2,2,0.4
bill_installment,1392,7,4,0.571428571429,0.75,1,0.142857142857,3,0.428571428571
bill_installment,1393,8,3,0.375,1.0,0,0.0,3,0.375
bill_installment,1394,5,1,0.2,0.0,1,0.2,0,0.0
bill_installment,1395,8,5,0.625,0.8,1,0.125,4,0.5
bill_installment,1396,7,3,0.428571428571,1.0,0,0.0,3,0.428571428571
bill_installment,1397,1,1,1.0,0.0,1,1.0,0,0.0
bill_installment,1398,6,4,0.666666666667,0.5,2,0.333333333333,2,0.333333333333
bill_installment,1399,3,1,0.333333333333,0.0,1,0.333333333333,0,0.0
bill_installment,1400,4,3,0.75,0.666666666667,1,0.25,2,0.5
bill_installment,1401,3,2,0.666666666667,1.0,0,0.0,2,0.666666666667
bill_installment,1402,4,2,0.5,1.0,0,0.0,2,0.5
bill_installment,1403,5,4,0.8,0.75,1,0.2,3,0.6
bill_installment,1404,1,0,0.0,NULL,0,0.0,0,0.0
bill_installment,1405,5,5,1.0,0.8,1,0.2,4,0.8
bill_installment,1406,5,1,0.2,0.0,1,0.2,0,0.0
bill_installment,1407,4,2,0.5,1.0,0,0.0,2,0.5
bill_installment,1408,5,2,0.4,1.0,0,0.0,2,0.4
bill_installment,1409,1,0,0.0,NULL,0,0.0,0,0.0
bill_installment,1410,2,1,0.5,0.0,1,0.5,0,0.0
bill_installment,1411,1,1,1.0,0.0,1,1.0,0,0.0
bill_installment,1412,6,2,0.333333333333,1.0,0,0.0,2,0.333333333333
bill_installment,1413,4,2,0.5,0.5,1,0.25,1,0.25
bill_installment,1414,3,1,0.333333333333,1.0,0,0.0,1,0.333333333333
bill_installment,1415,5,4,0.8,0.75,1,0.2,3,0.6
bill_installment,1416,5,2,0.4,0.5,1,0.2,1,0.2
bill_installment,1417,7,3,0.428571428571,0.666666666667,1,0.142857142857,2,0.285714285714
bill_installment,1418,1,0,0.0,NULL,0,0.0,0,0.0
bill_installment,1419,5,3,0.6,0.666666666667,1,0.2,2,0.4
bill_installment,1420,3,1,0.333333333333,1.0,0,0.0,1,0.333333333333
bill_installment,1421,3,3,1.0,0.666666666667,1,0.333333333333,2,0.666666666667
bill_installment,1422,2,1,0.5,0.0,1,0.5,0,0.0
bill_installment,1423,10,5,0.5,0.4,3,0.3,2,0.2
bill_installment,1424,3,1,0.333333333333,0.0,1,0.333333333333,0,0.0
bill_installment,1425,4,2,0.5,0.5,1,0.25,1,0.25
bill_installment,1426,6,3,0.5,0.333333333333,2,0.333333333333,1,0.166666666667
bill_installment,1427,6,3,0.5,1.0,0,0.0,3,0.5
bill_installment,1428,6,4,0.666666666667,1.0,0,0.0,4,0.666666666667
bill_installment,1429,6,4,0.666666666667,1.0,0,0.0,4,0.666666666667
bill_installment,1430,4,1,0.25,1.0,0,0.0,1,0.25
bill_installment,1431,2,0,0.0,NULL,0,0.0,0,0.0
bill_installment,1432,8,3,0.375,0.333333333333,2,0.25,1,0.125
bill_installment,1433,4,3,0.75,0.333333333333,2,0.5,1,0.25
bill_installment,1434,2,1,0.5,0.0,1,0.5,0,0.0
bill_installment,1435,3,2,0.666666666667,1.0,0,0.0,2,0.666666666667
bill_installment,1436,6,3,0.5,0.666666666667,1,0.166666666667,2,0.333333333333
bill_installment,1437,4,1,0.25,1.0,0,0.0,1,0.25
bill_installment,1438,3,2,0.666666666667,1.0,0,0.0,2,0.666666666667
bill_installment,1439,4,1,0.25,0.0,1,0.25,0,0.0
bill_installment,1440,5,5,1.0,0.2,4,0.8,1,0.2
bill_installment,1441,3,1,0.333333333333,0.0,1,0.333333333333,0,0.0
bill_installment,1442,5,4,0.8,0.5,2,0.4,2,0.4
bill_installment,1443,2,0,0.0,NULL,0,0.0,0,0.0
bill_installment,1444,4,1,0.25,0.0,1,0.25,0,0.0
bill_installment,1446,3,2,0.666666666667,0.5,1,0.333333333333,1,0.333333333333
bill_installment,1448,2,0,0.0,NULL,0,0.0,0,0.0
bill_installment,1449,5,3,0.6,0.666666666667,1,0.2,2,0.4
bill_installment,1450,4,3,0.75,1.0,0,0.0,3,0.75
bill_installment,1451,2,1,0.5,1.0,0,0.0,1,0.5
bill_installment,1452,2,0,0.0,NULL,0,0.0,0,0.0
bill_installment,1453,3,1,0.333333333333,1.0,0,0.0,1,0.333333333333
bill_installment,1454,4,3,0.75,0.666666666667,1,0.25,2,0.5
bill_installment,1455,2,2,1.0,1.0,0,0.0,2,1.0
bill_installment,1456,7,5,0.714285714286,0.8,1,0.142857142857,4,0.571428571429
bill_installment,1457,4,2,0.5,0.5,1,0.25,1,0.25
bill_installment,1458,7,3,0.428571428571,1.0,0,0.0,3,0.428571428571
bill_installment,1459,2,1,0.5,1.0,0,0.0,1,0.5
bill_installment,1460,4,3,0.75,1.0,0,0.0,3,0.75
bill_installment,1461,3,2,0.666666666667,0.5,1,0.333333333333,1,0.333333333333
bill_installment,1463,5,5,1.0,0.6,2,0.4,3,0.6
bill_installment,1464,3,2,0.666666666667,1.0,0,0.0,2,0.666666666667
bill_installment,1465,4,3,0.75,0.333333333333,2,0.5,1,0.25
bill_installment,1466,7,5,0.714285714286,0.4,3,0.428571428571,2,0.285714285714
bill_installment,1467,2,1,0.5,1.0,0,0.0,1,0.5
bill_installment,1468,1,1,1.0,1.0,0,0.0,1,1.0
bill_installment,1469,2,2,1.0,0.5,1,0.5,1,0.5
bill_installment,1470,3,0,0.0,NULL,0,0.0,0,0.0
bill_installment,1471,8,3,0.375,1.0,0,0.0,3,0.375
bill_installment,1472,5,2,0.4,1.0,0,0.0,2,0.4
bill_installment,1474,3,3,1.0,0.333333333333,2,0.666666666667,1,0.333333333333
bill_installment,1475,3,3,1.0,1.0,0,0.0,3,1.0
bill_installment,1476,2,1,0.5,1.0,0,0.0,1,0.5
bill_installment,1477,2,2,1.0,1.0,0,0.0,2,1.0
bill_installment,1478,4,2,0.5,1.0,0,0.0,2,0.5
bill_installment,1479,6,1,0.166666666667,1.0,0,0.0,1,0.166666666667
bill_installment,1480,6,3,0.5,1.0,0,0.0,3,0.5
bill_installment,1481,6,4,0.666666666667,1.0,0,0.0,4,0.666666666667
bill_installment,1482,3,2,0.666666666667,0.0,2,0.666666666667,0,0.0
bill_installment,1483,5,3,0.6,1.0,0,0.0,3,0.6
bill_installment,1484,4,2,0.5,0.5,1,0.25,1,0.25
bill_installment,1485,1,1,1.0,0.0,1,1.0,0,0.0
bill_installment,1486,3,2,0.666666666667,0.5,1,0.333333333333,1,0.333333333333
bill_installment,1487,2,0,0.0,NULL,0,0.0,0,0.0
bill_installment,1488,3,2,0.666666666667,1.0,0,0.0,2,0.666666666667
bill_installment,1489,3,2,0.666666666667,1.0,0,0.0,2,0.666666666667
bill_installment,1490,4,3,0.75,1.0,0,0.0,3,0.75
bill_installment,1491,2,0,0.0,NULL,0,0.0,0,0.0
bill_installment,1492,7,4,0.571428571429,1.0,0,0.0,4,0.571428571429
bill_installment,1493,7,3,0.428571428571,0.666666666667,1,0.142857142857,2,0.285714285714
bill_installment,1494,3,2,0.666666666667,0.5,1,0.333333333333,1,0.333333333333
bill_installment,1495,2,2,1.0,1.0,0,0.0,2,1.0
bill_installment,1496,4,4,1.0,0.5,2,0.5,2,0.5
bill_installment,1497,5,4,0.8,0.75,1,0.2,3,0.6
bill_installment,1498,8,4,0.5,0.5,2,0.25,2,0.25
bill_installment,1499,2,0,0.0,NULL,0,0.0,0,0.0
bill_installment,1500,5,4,0.8,0.5,2,0.4,2,0.4
bill_installment,1501,5,4,0.8,1.0,0,0.0,4,0.8
bill_installment,1502,2,1,0.5,1.0,0,0.0,1,0.5
bill_installment,1503,3,1,0.333333333333,0.0,1,0.333333333333,0,0.0
bill_installment,1504,6,5,0.833333333333,0.8,1,0.166666666667,4,0.666666666667
bill_installment,1505,1,0,0.0,NULL,0,0.0,0,0.0
bill_installment,1506,4,2,0.5,0.5,1,0.25,1,0.25
bill_installment,1507,3,2,0.666666666667,1.0,0,0.0,2,0.666666666667
bill_installment,1508,3,1,0.333333333333,1.0,0,0.0,1,0.333333333333
bill_installment,1509,1,1,1.0,0.0,1,1.0,0,0.0
bill_installment,1510,1,0,0.0,NULL,0,0.0,0,0.0
bill_installment,1511,10,5,0.5,0.8,1,0.1,4,0.4
bill_installment,1512,3,3,1.0,0.666666666667,1,0.333333333333,2,0.666666666667
bill_installment,1513,3,2,0.666666666667,1.0,0,0.0,2,0.666666666667
bill_installment,1514,4,3,0.75,1.0,0,0.0,3,0.75
bill_installment,1515,2,1,0.5,0.0,1,0.5,0,0.0
bill_installment,1516,7,6,0.857142857143,0.833333333333,1,0.142857142857,5,0.714285714286
bill_installment,1517,3,3,1.0,0.666666666667,1,0.333333333333,2,0.666666666667
bill_installment,1518,2,1,0.5,1.0,0,0.0,1,0.5
bill_installment,1519,6,5,0.833333333333,1.0,0,0.0,5,0.833333333333
bill_installment,1520,3,1,0.333333333333,1.0,0,0.0,1,0.333333333333
bill_installment,1521,3,3,1.0,0.666666666667,1,0.333333333333,2,0.666666666667
bill_installment,1522,6,4,0.666666666667,0.5,2,0.333333333333,2,0.333333333333
bill_installment,1523,2,1,0.5,1.0,0,0.0,1,0.5
bill_installment,1524,2,2,1.0,1.0,0,0.0,2,1.0
bill_installment,1525,5,2,0.4,0.5,1,0.2,1,0.2
bill_installment,1526,2,2,1.0,0.5,1,0.5,1,0.5
bill_installment,1528,2,1,0.5,0.0,1,0.5,0,0.0
bill_installment,1529,3,2,0.666666666667,0.5,1,0.333333333333,1,0.333333333333
bill_installment,1530,7,2,0.285714285714,0.0,2,0.285714285714,0,0.0
bill_installment,1531,2,1,0.5,0.0,1,0.5,0,0.0
bill_installment,1532,3,2,0.666666666667,0.5,1,0.333333333333,1,0.333333333333
bill_installment,1533,1,1,1.0,1.0,0,0.0,1,1.0
bill_installment,1534,2,0,0.0,NULL,0,0.0,0,0.0
bill_installment,1535,4,2,0.5,0.5,1,0.25,1,0.25
bill_installment,1536,3,2,0.666666666667,1.0,0,0.0,2,0.666666666667
bill_installment,1537,1,1,1.0,1.0,0,0.0,1,1.0
bill_installment,1539,5,2,0.4,1.0,0,0.0,2,0.4
bill_installment,1540,6,2,0.333333333333,0.5,1,0.166666666667,1,0.166666666667
bill_installment,1541,3,1,0.333333333333,1.0,0,0.0,1,0.333333333333
bill_installment,1542,3,3,1.0,1.0,0,0.0,3,1.0
bill_installment,1543,2,1,0.5,0.0,1,0.5,0,0.0
bill_installment,1544,3,1,0.333333333333,1.0,0,0.0,1,0.333333333333
bill_installment,1545,1,1,1.0,0.0,1,1.0,0,0.0
bill_installment,1546,7,2,0.285714285714,0.5,1,0.142857142857,1,0.142857142857
bill_installment,1547,1,1,1.0,1.0,0,0.0,1,1.0
bill_installment,1548,8,4,0.5,0.5,2,0.25,2,0.25
bill_installment,1549,3,2,0.666666666667,0.5,1,0.333333333333,1,0.333333333333
bill_installment,1550,7,5,0.714285714286,0.8,1,0.142857142857,4,0.571428571429
bill_installment,1551,5,2,0.4,1.0,0,0.0,2,0.4
bill_installment,1552,4,3,0.75,1.0,0,0.0,3,0.75
bill_installment,1553,4,1,0.25,1.0,0,0.0,1,0.25
bill_installment,1554,8,5,0.625,0.6,2,0.25,3,0.375
bill_installment,1555,1,0,0.0,NULL,0,0.0,0,0.0
bill_installment,1556,3,2,0.666666666667,1.0,0,0.0,2,0.666666666667
bill_installment,1557,3,1,0.333333333333,1.0,0,0.0,1,0.333333333333
bill_installment,1558,2,0,0.0,NULL,0,0.0,0,0.0
bill_installment,1559,1,1,1.0,0.0,1,1.0,0,0.0
bill_installment,1560,4,1,0.25,1.0,0,0.0,1,0.25
bill_installment,1561,1,1,1.0,1.0,0,0.0,1,1.0
bill_installment,1562,1,1,1.0,1.0,0,0.0,1,1.0
bill_installment,1563,6,2,0.333333333333,1.0,0,0.0,2,0.333333333333
bill_installment,1564,1,1,1.0,1.0,0,0.0,1,1.0
bill_installment,1565,3,1,0.333333333333,1.0,0,0.0,1,0.333333333333
bill_installment,1566,4,2,0.5,0.5,1,0.25,1,0.25
bill_installment,1567,2,2,1.0,1.0,0,0.0,2,1.0
bill_installment,1568,5,2,0.4,1.0,0,0.0,2,0.4
bill_installment,1569,5,3,0.6,0.666666666667,1,0.2,2,0.4
bill_installment,1570,4,2,0.5,1.0,0,0.0,2,0.5
bill_installment,1571,2,1,0.5,1.0,0,0.0,1,0.5
bill_installment,1573,3,2,0.666666666667,1.0,0,0.0,2,0.666666666667
bill_installment,1574,2,1,0.5,1.0,0,0.0,1,0.5
bill_installment,1575,1,1,1.0,1.0,0,0.0,1,1.0
bill_installment,1577,1,0,0.0,NULL,0,0.0,0,0.0
bill_installment,1578,2,2,1.0,0.5,1,0.5,1,0.5
bill_installment,1579,2,0,0.0,NULL,0,0.0,0,0.0
bill_installment,1580,4,2,0.5,1.0,0,0.0,2,0.5
bill_installment,1581,3,1,0.333333333333,0.0,1,0.333333333333,0,0.0
bill_installment,1582,5,2,0.4,0.5,1,0.2,1,0.2
bill_installment,1583,6,3,0.5,0.666666666667,1,0.166666666667,2,0.333333333333
bill_installment,1584,2,2,1.0,1.0,0,0.0,2,1.0
bill_installment,1585,4,0,0.0,NULL,0,0.0,0,0.0
bill_installment,1586,1,1,1.0,1.0,0,0.0,1,1.0
bill_installment,1587,2,1,0.5,0.0,1,0.5,0,0.0
bill_installment,1588,1,0,0.0,NULL,0,0.0,0,0.0
bill_installment,1589,2,1,0.5,1.0,0,0.0,1,0.5
bill_installment,1590,2,1,0.5,1.0,0,0.0,1,0.5
bill_installment,1591,1,1,1.0,1.0,0,0.0,1,1.0
bill_installment,1592,5,3,0.6,0.333333333333,2,0.4,1,0.2
bill_installment,1593,1,0,0.0,NULL,0,0.0,0,0.0
bill_installment,1594,5,2,0.4,1.0,0,0.0,2,0.4
bill_installment,1595,2,1,0.5,0.0,1,0.5,0,0.0
bill_installment,1596,2,1,0.5,1.0,0,0.0,1,0.5
bill_installment,1597,2,1,0.5,1.0,0,0.0,1,0.5
bill_installment,1598,2,2,1.0,0.0,2,1.0,0,0.0
bill_installment,1599,2,2,1.0,1.0,0,0.0,2,1.0
bill_installment,1600,1,1,1.0,1.0,0,0.0,1,1.0
bill_installment,1601,4,2,0.5,1.0,0,0.0,2,0.5
bill_installment,1602,2,1,0.5,1.0,0,0.0,1,0.5
bill_installment,1603,5,0,0.0,NULL,0,0.0,0,0.0
bill_installment,1604,4,0,0.0,NULL,0,0.0,0,0.0
bill_installment,1605,4,2,0.5,0.5,1,0.25,1,0.25
bill_installment,1606,4,3,0.75,0.666666666667,1,0.25,2,0.5
bill_installment,1607,2,1,0.5,1.0,0,0.0,1,0.5
bill_installment,1608,1,0,0.0,NULL,0,0.0,0,0.0
bill_installment,1609,2,2,1.0,0.5,1,0.5,1,0.5
bill_installment,1610,2,1,0.5,0.0,1,0.5,0,0.0
bill_installment,1611,1,1,1.0,1.0,0,0.0,1,1.0
bill_installment,1612,1,0,0.0,NULL,0,0.0,0,0.0
bill_installment,1613,4,0,0.0,NULL,0,0.0,0,0.0
bill_installment,1614,2,2,1.0,0.5,1,0.5,1,0.5
bill_installment,1615,2,1,0.5,1.0,0,0.0,1,0.5
bill_installment,1616,5,4,0.8,0.75,1,0.2,3,0.6
bill_installment,1617,1,1,1.0,1.0,0,0.0,1,1.0
bill_installment,1618,4,2,0.5,0.5,1,0.25,1,0.25
bill_installment,1619,2,0,0.0,NULL,0,0.0,0,0.0
bill_installment,1620,2,2,1.0,1.0,0,0.0,2,1.0
bill_installment,1621,1,1,1.0,0.0,1,1.0,0,0.0
bill_installment,1622,3,2,0.666666666667,1.0,0,0.0,2,0.666666666667
bill_installment,1623,1,1,1.0,1.0,0,0.0,1,1.0
bill_installment,1624,3,0,0.0,NULL,0,0.0,0,0.0
bill_installment,1625,4,1,0.25,1.0,0,0.0,1,0.25
bill_installment,1626,1,1,1.0,1.0,0,0.0,1,1.0
bill_installment,1627,1,1,1.0,1.0,0,0.0,1,1.0
bill_installment,1628,2,0,0.0,NULL,0,0.0,0,0.0
bill_installment,1629,3,2,0.666666666667,1.0,0,0.0,2,0.666666666667
bill_installment,1630,4,3,0.75,0.0,3,0.75,0,0.0
bill_installment,1631,1,0,0.0,NULL,0,0.0,0,0.0
bill_installment,1632,2,0,0.0,NULL,0,0.0,0,0.0
bill_installment,1633,6,3,0.5,0.333333333333,2,0.333333333333,1,0.166666666667
bill_installment,1634,3,2,0.666666666667,0.5,1,0.333333333333,1,0.333333333333
bill_installment,1636,1,1,1.0,1.0,0,0.0,1,1.0
bill_installment,1637,4,2,0.5,0.5,1,0.25,1,0.25
bill_installment,1638,2,1,0.5,1.0,0,0.0,1,0.5
bill_installment,1639,2,0,0.0,NULL,0,0.0,0,0.0
bill_installment,1640,5,1,0.2,0.0,1,0.2,0,0.0
bill_installment,1641,1,0,0.0,NULL,0,0.0,0,0.0
bill_installment,1642,2,1,0.5,1.0,0,0.0,1,0.5
bill_installment,1643,3,2,0.666666666667,1.0,0,0.0,2,0.666666666667
bill_installment,1644,3,2,0.666666666667,0.5,1,0.333333333333,1,0.333333333333
bill_installment,1645,2,1,0.5,0.0,1,0.5,0,0.0
bill_installment,1646,2,2,1.0,1.0,0,0.0,2,1.0
bill_installment,1647,2,2,1.0,0.5,1,0.5,1,0.5
bill_installment,1648,2,1,0.5,1.0,0,0.0,1,0.5
bill_installment,1649,4,3,0.75,1.0,0,0.0,3,0.75
bill_installment,1650,2,2,1.0,1.0,0,0.0,2,1.0
bill_installment,1651,1,1,1.0,1.0,0,0.0,1,1.0
bill_installment,1652,5,3,0.6,0.333333333333,2,0.4,1,0.2
bill_installment,1653,2,2,1.0,1.0,0,0.0,2,1.0
bill_installment,1654,3,2,0.666666666667,1.0,0,0.0,2,0.666666666667
bill_installment,1655,4,2,0.5,1.0,0,0.0,2,0.5
bill_installment,1656,3,2,0.666666666667,0.5,1,0.333333333333,1,0.333333333333
bill_installment,1657,1,1,1.0,1.0,0,0.0,1,1.0
bill_installment,1658,1,0,0.0,NULL,0,0.0,0,0.0
bill_installment,1659,4,2,0.5,1.0,0,0.0,2,0.5
bill_installment,1660,1,0,0.0,NULL,0,0.0,0,0.0
bill_installment,1661,4,2,0.5,1.0,0,0.0,2,0.5
bill_installment,1662,1,1,1.0,1.0,0,0.0,1,1.0
bill_installment,1663,3,2,0.666666666667,1.0,0,0.0,2,0.666666666667
bill_installment,1664,1,1,1.0,1.0,0,0.0,1,1.0
bill_installment,1665,2,2,1.0,1.0,0,0.0,2,1.0
bill_installment,1666,3,3,1.0,0.666666666667,1,0.333333333333,2,0.666666666667
bill_installment,1667,2,1,0.5,1.0,0,0.0,1,0.5
bill_installment,1668,2,0,0.0,NULL,0,0.0,0,0.0
bill_installment,1669,1,1,1.0,0.0,1,1.0,0,0.0
bill_installment,1670,3,2,0.666666666667,1.0,0,0.0,2,0.666666666667
bill_installment,1671,2,1,0.5,1.0,0,0.0,1,0.5
bill_installment,1672,5,3,0.6,0.666666666667,1,0.2,2,0.4
bill_installment,1673,1,1,1.0,0.0,1,1.0,0,0.0
bill_installment,1674,3,2,0.666666666667,1.0,0,0.0,2,0.666666666667
bill_installment,1675,1,0,0.0,NULL,0,0.0,0,0.0
bill_installment,1676,1,0,0.0,NULL,0,0.0,0,0.0
bill_installment,1678,3,1,0.333333333333,0.0,1,0.333333333333,0,0.0
bill_installment,1679,2,0,0.0,NULL,0,0.0,0,0.0
bill_installment,1680,3,2,0.666666666667,0.5,1,0.333333333333,1,0.333333333333
bill_installment,1681,4,3,0.75,0.666666666667,1,0.25,2,0.5
bill_installment,1683,1,1,1.0,1.0,0,0.0,1,1.0
bill_installment,1684,2,1,0.5,1.0,0,0.0,1,0.5
bill_installment,1685,5,1,0.2,1.0,0,0.0,1,0.2
bill_installment,1686,5,1,0.2,1.0,0,0.0,1,0.2
bill_installment,1687,1,1,1.0,1.0,0,0.0,1,1.0
bill_installment,1688,4,2,0.5,1.0,0,0.0,2,0.5
bill_installment,1689,2,1,0.5,1.0,0,0.0,1,0.5
bill_installment,1690,2,1,0.5,1.0,0,0.0,1,0.5
bill_installment,1691,1,0,0.0,NULL,0,0.0,0,0.0
bill_installment,1692,2,2,1.0,1.0,0,0.0,2,1.0
bill_installment,1694,2,1,0.5,1.0,0,0.0,1,0.5
bill_installment,1695,3,1,0.333333333333,0.0,1,0.333333333333,0,0.0
bill_installment,1696,3,2,0.666666666667,1.0,0,0.0,2,0.666666666667
bill_installment,1697,1,1,1.0,1.0,0,0.0,1,1.0
bill_installment,1698,2,1,0.5,1.0,0,0.0,1,0.5
bill_installment,1699,1,0,0.0,NULL,0,0.0,0,0.0
bill_installment,1700,2,1,0.5,1.0,0,0.0,1,0.5
bill_installment,1701,1,1,1.0,1.0,0,0.0,1,1.0
bill_installment,1702,4,3,0.75,0.666666666667,1,0.25,2,0.5
bill_installment,1704,4,2,0.5,1.0,0,0.0,2,0.5
bill_installment,1705,2,1,0.5,1.0,0,0.0,1,0.5
bill_installment,1706,3,2,0.666666666667,0.5,1,0.333333333333,1,0.333333333333
bill_installment,1707,2,0,0.0,NULL,0,0.0,0,0.0
bill_installment,1708,4,3,0.75,0.666666666667,1,0.25,2,0.5
bill_installment,1709,1,1,1.0,1.0,0,0.0,1,1.0
bill_installment,1710,1,0,0.0,NULL,0,0.0,0,0.0
bill_installment,1711,1,0,0.0,NULL,0,0.0,0,0.0
bill_installment,1712,3,1,0.333333333333,1.0,0,0.0,1,0.333333333333
bill_installment,1713,2,1,0.5,1.0,0,0.0,1,0.5
bill_installment,1714,5,3,0.6,1.0,0,0.0,3,0.6
bill_installment,1716,1,0,0.0,NULL,0,0.0,0,0.0
bill_installment,1717,1,0,0.0,NULL,0,0.0,0,0.0
bill_installment,1718,2,2,1.0,0.5,1,0.5,1,0.5
bill_installment,1719,3,2,0.666666666667,0.0,2,0.666666666667,0,0.0
bill_installment,1720,2,0,0.0,NULL,0,0.0,0,0.0
bill_installment,1721,3,3,1.0,1.0,0,0.0,3,1.0
bill_installment,1722,2,0,0.0,NULL,0,0.0,0,0.0
bill_installment,1723,1,0,0.0,NULL,0,0.0,0,0.0
bill_installment,1724,3,1,0.333333333333,0.0,1,0.333333333333,0,0.0
bill_installment,1725,6,4,0.666666666667,0.25,3,0.5,1,0.166666666667
bill_installment,1726,1,1,1.0,1.0,0,0.0,1,1.0
bill_installment,1727,4,1,0.25,0.0,1,0.25,0,0.0
bill_installment,1728,1,0,0.0,NULL,0,0.0,0,0.0
bill_installment,1729,2,1,0.5,1.0,0,0.0,1,0.5
bill_installment,1730,5,2,0.4,0.5,1,0.2,1,0.2
bill_installment,1731,1,1,1.0,1.0,0,0.0,1,1.0
bill_installment,1732,3,1,0.333333333333,1.0,0,0.0,1,0.333333333333
bill_installment,1733,3,1,0.333333333333,1.0,0,0.0,1,0.333333333333
bill_installment,1734,1,0,0.0,NULL,0,0.0,0,0.0
bill_installment,1735,3,1,0.333333333333,1.0,0,0.0,1,0.333333333333
bill_installment,1736,3,1,0.333333333333,1.0,0,0.0,1,0.333333333333
bill_installment,1737,2,2,1.0,0.0,2,1.0,0,0.0
bill_installment,1738,1,1,1.0,1.0,0,0.0,1,1.0
bill_installment,1739,4,2,0.5,0.5,1,0.25,1,0.25
bill_installment,1740,2,1,0.5,0.0,1,0.5,0,0.0
bill_installment,1741,1,0,0.0,NULL,0,0.0,0,0.0
bill_installment,1742,2,2,1.0,1.0,0,0.0,2,1.0
bill_installment,1743,3,2,0.666666666667,0.5,1,0.333333333333,1,0.333333333333
bill_installment,1744,1,1,1.0,0.0,1,1.0,0,0.0
bill_installment,1745,4,3,0.75,1.0,0,0.0,3,0.75
bill_installment,1746,3,2,0.666666666667,1.0,0,0.0,2,0.666666666667
bill_installment,1747,2,1,0.5,1.0,0,0.0,1,0.5
bill_installment,1748,4,4,1.0,0.5,2,0.5,2,0.5
bill_installment,1750,1,1,1.0,1.0,0,0.0,1,1.0
bill_installment,1752,1,0,0.0,NULL,0,0.0,0,0.0
bill_installment,1753,1,0,0.0,NULL,0,0.0,0,0.0
bill_installment,1754,3,1,0.333333333333,1.0,0,0.0,1,0.333333333333
bill_installment,1755,2,0,0.0,NULL,0,0.0,0,0.0
bill_installment,1759,5,3,0.6,0.666666666667,1,0.2,2,0.4
bill_installment,1760,3,1,0.333333333333,1.0,0,0.0,1,0.333333333333
bill_installment,1761,1,0,0.0,NULL,0,0.0,0,0.0
bill_installment,1762,1,1,1.0,1.0,0,0.0,1,1.0
bill_installment,1763,3,3,1.0,1.0,0,0.0,3,1.0
bill_installment,1765,2,1,0.5,1.0,0,0.0,1,0.5
bill_installment,1766,4,2,0.5,1.0,0,0.0,2,0.5
bill_installment,1767,1,0,0.0,NULL,0,0.0,0,0.0
bill_installment,1768,4,1,0.25,1.0,0,0.0,1,0.25
bill_installment,1769,4,4,1.0,0.75,1,0.25,3,0.75
bill_installment,1770,3,1,0.333333333333,1.0,0,0.0,1,0.333333333333
bill_installment,1772,2,1,0.5,1.0,0,0.0,1,0.5
bill_installment,1773,3,3,1.0,0.666666666667,1,0.333333333333,2,0.666666666667
bill_installment,1774,2,1,0.5,1.0,0,0.0,1,0.5
bill_installment,1775,1,0,0.0,NULL,0,0.0,0,0.0
bill_installment,1777,1,1,1.0,1.0,0,0.0,1,1.0
bill_installment,1778,5,0,0.0,NULL,0,0.0,0,0.0
bill_installment,1779,1,1,1.0,1.0,0,0.0,1,1.0
bill_installment,1781,2,1,0.5,0.0,1,0.5,0,0.0
bill_installment,1782,1,1,1.0,1.0,0,0.0,1,1.0
bill_installment,1783,1,1,1.0,1.0,0,0.0,1,1.0
bill_installment,1785,2,1,0.5,1.0,0,0.0,1,0.5
bill_installment,1787,2,2,1.0,0.5,1,0.5,1,0.5
bill_installment,1788,3,3,1.0,1.0,0,0.0,3,1.0
bill_installment,1789,2,0,0.0,NULL,0,0.0,0,0.0
bill_installment,1790,3,2,0.666666666667,0.5,1,0.333333333333,1,0.333333333333
bill_installment,1793,1,1,1.0,1.0,0,0.0,1,1.0
bill_installment,1794,1,0,0.0,NULL,0,0.0,0,0.0
bill_installment,1795,1,0,0.0,NULL,0,0.0,0,0.0
bill_installment,1796,4,3,0.75,1.0,0,0.0,3,0.75
bill_installment,1797,1,1,1.0,0.0,1,1.0,0,0.0
bill_installment,1798,3,1,0.333333333333,0.0,1,0.333333333333,0,0.0
bill_installment,1799,2,1,0.5,1.0,0,0.0,1,0.5
bill_installment,1800,4,4,1.0,1.0,0,0.0,4,1.0
bill_installment,1801,3,1,0.333333333333,1.0,0,0.0,1,0.333333333333
bill_installment,1802,2,1,0.5,1.0,0,0.0,1,0.5
bill_installment,1803,1,0,0.0,NULL,0,0.0,0,0.0
bill_installment,1804,1,0,0.0,NULL,0,0.0,0,0.0
bill_installment,1805,1,1,1.0,1.0,0,0.0,1,1.0
bill_installment,1806,3,1,0.333333333333,1.0,0,0.0,1,0.333333333333
bill_installment,1807,2,1,0.5,1.0,0,0.0,1,0.5
bill_installment,1808,3,2,0.666666666667,1.0,0,0.0,2,0.666666666667
bill_installment,1809,2,2,1.0,0.5,1,0.5,1,0.5
bill_installment,1810,2,0,0.0,NULL,0,0.0,0,0.0
bill_installment,1811,1,0,0.0,NULL,0,0.0,0,0.0
bill_installment,1812,2,1,0.5,1.0,0,0.0,1,0.5
bill_installment,1813,2,1,0.5,1.0,0,0.0,1,0.5
bill_installment,1814,3,2,0.666666666667,1.0,0,0.0,2,0.666666666667
bill_installment,1815,1,1,1.0,1.0,0,0.0,1,1.0
bill_installment,1817,1,0,0.0,NULL,0,0.0,0,0.0
bill_installment,1818,1,1,1.0,1.0,0,0.0,1,1.0
bill_installment,1819,2,0,0.0,NULL,0,0.0,0,0.0
bill_installment,1820,1,1,1.0,1.0,0,0.0,1,1.0
bill_installment,1821,4,1,0.25,0.0,1,0.25,0,0.0
bill_installment,1822,2,1,0.5,0.0,1,0.5,0,0.0
bill_installment,1823,2,1,0.5,1.0,0,0.0,1,0.5
bill_installment,1824,2,1,0.5,1.0,0,0.0,1,0.5
bill_installment,1825,3,0,0.0,NULL,0,0.0,0,0.0
bill_installment,1827,1,1,1.0,0.0,1,1.0,0,0.0
bill_installment,1828,1,0,0.0,NULL,0,0.0,0,0.0
bill_installment,1829,1,1,1.0,0.0,1,1.0,0,0.0
bill_installment,1830,3,0,0.0,NULL,0,0.0,0,0.0
bill_installment,1832,3,2,0.666666666667,0.5,1,0.333333333333,1,0.333333333333
bill_installment,1833,2,1,0.5,1.0,0,0.0,1,0.5
bill_installment,1834,1,0,0.0,NULL,0,0.0,0,0.0
bill_installment,1835,2,1,0.5,1.0,0,0.0,1,0.5
bill_installment,1837,3,3,1.0,0.666666666667,1,0.333333333333,2,0.666666666667
bill_installment,1838,2,1,0.5,1.0,0,0.0,1,0.5
bill_installment,1839,1,1,1.0,0.0,1,1.0,0,0.0
bill_installment,1840,1,0,0.0,NULL,0,0.0,0,0.0
bill_installment,1841,1,1,1.0,0.0,1,1.0,0,0.0
bill_installment,1842,2,2,1.0,0.5,1,0.5,1,0.5
bill_installment,1843,3,1,0.333333333333,1.0,0,0.0,1,0.333333333333
bill_installment,1844,2,2,1.0,1.0,0,0.0,2,1.0
bill_installment,1845,6,4,0.666666666667,1.0,0,0.0,4,0.666666666667
bill_installment,1846,2,0,0.0,NULL,0,0.0,0,0.0
bill_installment,1847,2,2,1.0,1.0,0,0.0,2,1.0
bill_installment,1848,2,0,0.0,NULL,0,0.0,0,0.0
bill_installment,1850,3,2,0.666666666667,1.0,0,0.0,2,0.666666666667
bill_installment,1852,3,3,1.0,0.333333333333,2,0.666666666667,1,0.333333333333
bill_installment,1853,2,1,0.5,1.0,0,0.0,1,0.5
bill_installment,1854,2,1,0.5,1.0,0,0.0,1,0.5
bill_installment,1857,1,0,0.0,NULL,0,0.0,0,0.0
bill_installment,1858,3,1,0.333333333333,0.0,1,0.333333333333,0,0.0
bill_installment,1859,3,2,0.666666666667,1.0,0,0.0,2,0.666666666667
bill_installment,1861,1,1,1.0,0.0,1,1.0,0,0.0
bill_installment,1863,1,1,1.0,1.0,0,0.0,1,1.0
bill_installment,1864,1,1,1.0,0.0,1,1.0,0,0.0
bill_installment,1865,1,1,1.0,1.0,0,0.0,1,1.0
bill_installment,1866,3,2,0.666666666667,1.0,0,0.0,2,0.666666666667
bill_installment,1867,2,1,0.5,1.0,0,0.0,1,0.5
bill_installment,1868,4,3,0.75,0.666666666667,1,0.25,2,0.5
bill_installment,1869,2,1,0.5,0.0,1,0.5,0,0.0
bill_installment,1870,1,0,0.0,NULL,0,0.0,0,0.0
bill_installment,1871,3,1,0.333333333333,0.0,1,0.333333333333,0,0.0
bill_installment,1872,2,1,0.5,1.0,0,0.0,1,0.5
bill_installment,1874,5,2,0.4,0.5,1,0.2,1,0.2
bill_installment,1875,1,1,1.0,1.0,0,0.0,1,1.0
bill_installment,1876,2,2,1.0,1.0,0,0.0,2,1.0
bill_installment,1877,1,1,1.0,0.0,1,1.0,0,0.0
bill_installment,1878,2,2,1.0,1.0,0,0.0,2,1.0
bill_installment,1879,1,1,1.0,0.0,1,1.0,0,0.0
bill_installment,1880,2,1,0.5,0.0,1,0.5,0,0.0
bill_installment,1882,3,1,0.333333333333,1.0,0,0.0,1,0.333333333333
bill_installment,1883,2,1,0.5,1.0,0,0.0,1,0.5
bill_installment,1884,4,2,0.5,0.5,1,0.25,1,0.25
bill_installment,1885,1,1,1.0,1.0,0,0.0,1,1.0
bill_installment,1886,3,2,0.666666666667,0.5,1,0.333333333333,1,0.333333333333
bill_installment,1888,2,1,0.5,1.0,0,0.0,1,0.5
bill_installment,1889,2,1,0.5,1.0,0,0.0,1,0.5
bill_installment,1890,1,1,1.0,1.0,0,0.0,1,1.0
bill_installment,1891,3,2,0.666666666667,0.0,2,0.666666666667,0,0.0
bill_installment,1892,2,2,1.0,0.5,1,0.5,1,0.5
bill_installment,1894,5,3,0.6,1.0,0,0.0,3,0.6
bill_installment,1895,1,1,1.0,1.0,0,0.0,1,1.0
bill_installment,1896,1,1,1.0,1.0,0,0.0,1,1.0
bill_installment,1898,2,0,0.0,NULL,0,0.0,0,0.0
bill_installment,1901,2,1,0.5,0.0,1,0.5,0,0.0
bill_installment,1902,1,0,0.0,NULL,0,0.0,0,0.0
bill_installment,1904,1,0,0.0,NULL,0,0.0,0,0.0
bill_installment,1905,4,2,0.5,0.5,1,0.25,1,0.25
bill_installment,1906,2,2,1.0,1.0,0,0.0,2,1.0
bill_installment,1907,4,3,0.75,1.0,0,0.0,3,0.75
bill_installment,1908,1,1,1.0,0.0,1,1.0,0,0.0
bill_installment,1909,3,1,0.333333333333,1.0,0,0.0,1,0.333333333333
bill_installment,1911,2,1,0.5,1.0,0,0.0,1,0.5
bill_installment,1912,1,1,1.0,0.0,1,1.0,0,0.0
bill_installment,1913,2,0,0.0,NULL,0,0.0,0,0.0
bill_installment,1914,6,1,0.166666666667,1.0,0,0.0,1,0.166666666667
bill_installment,1915,3,1,0.333333333333,1.0,0,0.0,1,0.333333333333
bill_installment,1916,2,1,0.5,0.0,1,0.5,0,0.0
bill_installment,1917,1,0,0.0,NULL,0,0.0,0,0.0
bill_installment,1919,1,0,0.0,NULL,0,0.0,0,0.0
bill_installment,1920,1,0,0.0,NULL,0,0.0,0,0.0
bill_installment,1923,1,1,1.0,1.0,0,0.0,1,1.0
bill_installment,1924,1,1,1.0,1.0,0,0.0,1,1.0
bill_installment,1925,4,3,0.75,0.666666666667,1,0.25,2,0.5
bill_installment,1926,1,1,1.0,0.0,1,1.0,0,0.0
bill_installment,1928,2,1,0.5,1.0,0,0.0,1,0.5
bill_installment,1929,1,1,1.0,1.0,0,0.0,1,1.0
bill_installment,1930,2,2,1.0,1.0,0,0.0,2,1.0
bill_installment,1931,1,0,0.0,NULL,0,0.0,0,0.0
bill_installment,1933,2,2,1.0,1.0,0,0.0,2,1.0
bill_installment,1934,4,2,0.5,1.0,0,0.0,2,0.5
bill_installment,1937,1,0,0.0,NULL,0,0.0,0,0.0
bill_installment,1938,2,2,1.0,0.5,1,0.5,1,0.5
bill_installment,1939,1,1,1.0,1.0,0,0.0,1,1.0
bill_installment,1942,4,3,0.75,1.0,0,0.0,3,0.75
bill_installment,1944,1,1,1.0,1.0,0,0.0,1,1.0
bill_installment,1945,2,0,0.0,NULL,0,0.0,0,0.0
bill_installment,1946,1,1,1.0,1.0,0,0.0,1,1.0
bill_installment,1947,1,0,0.0,NULL,0,0.0,0,0.0
bill_installment,1950,2,1,0.5,1.0,0,0.0,1,0.5
bill_installment,1951,1,0,0.0,NULL,0,0.0,0,0.0
bill_installment,1952,1,1,1.0,1.0,0,0.0,1,1.0
bill_installment,1953,1,0,0.0,NULL,0,0.0,0,0.0
bill_installment,1954,1,0,0.0,NULL,0,0.0,0,0.0
bill_installment,1955,2,2,1.0,1.0,0,0.0,2,1.0
bill_installment,1956,1,1,1.0,1.0,0,0.0,1,1.0
bill_installment,1958,3,2,0.666666666667,1.0,0,0.0,2,0.666666666667
bill_installment,1959,1,0,0.0,NULL,0,0.0,0,0.0
bill_installment,1960,1,1,1.0,0.0,1,1.0,0,0.0
bill_installment,1961,1,0,0.0,NULL,0,0.0,0,0.0
bill_installment,1962,3,2,0.666666666667,1.0,0,0.0,2,0.666666666667
bill_installment,1963,1,1,1.0,1.0,0,0.0,1,1.0
bill_installment,1965,2,1,0.5,0.0,1,0.5,0,0.0
bill_installment,1966,1,1,1.0,0.0,1,1.0,0,0.0
bill_installment,1967,3,2,0.666666666667,1.0,0,0.0,2,0.666666666667
bill_installment,1968,2,1,0.5,1.0,0,0.0,1,0.5
bill_installment,1969,1,1,1.0,1.0,0,0.0,1,1.0
bill_installment,1970,3,1,0.333333333333,1.0,0,0.0,1,0.333333333333
bill_installment,1973,2,2,1.0,0.5,1,0.5,1,0.5
bill_installment,1974,1,0,0.0,NULL,0,0.0,0,0.0
bill_installment,1975,1,1,1.0,0.0,1,1.0,0,0.0
bill_installment,1977,1,1,1.0,0.0,1,1.0,0,0.0
bill_installment,1978,1,1,1.0,0.0,1,1.0,0,0.0
bill_installment,1980,3,1,0.333333333333,1.0,0,0.0,1,0.333333333333
bill_installment,1982,2,2,1.0,0.5,1,0.5,1,0.5
bill_installment,1984,1,1,1.0,1.0,0,0.0,1,1.0
bill_installment,1985,2,1,0.5,0.0,1,0.5,0,0.0
bill_installment,1986,3,0,0.0,NULL,0,0.0,0,0.0
bill_installment,1987,2,1,0.5,1.0,0,0.0,1,0.5
bill_installment,1988,2,2,1.0,1.0,0,0.0,2,1.0
bill_installment,1990,1,0,0.0,NULL,0,0.0,0,0.0
bill_installment,1992,2,0,0.0,NULL,0,0.0,0,0.0
bill_installment,1993,1,1,1.0,0.0,1,1.0,0,0.0
bill_installment,1994,2,2,1.0,1.0,0,0.0,2,1.0
bill_installment,1995,1,0,0.0,NULL,0,0.0,0,0.0
bill_installment,1996,1,1,1.0,1.0,0,0.0,1,1.0
bill_installment,1997,2,2,1.0,0.5,1,0.5,1,0.5
bill_installment,1998,1,1,1.0,1.0,0,0.0,1,1.0
bill_installment,2001,1,0,0.0,NULL,0,0.0,0,0.0
bill_installment,2002,1,0,0.0,NULL,0,0.0,0,0.0
bill_installment,2003,5,4,0.8,0.25,3,0.6,1,0.2
bill_installment,2004,1,0,0.0,NULL,0,0.0,0,0.0
bill_installment,2005,2,1,0.5,0.0,1,0.5,0,0.0
bill_installment,2006,1,0,0.0,NULL,0,0.0,0,0.0
bill_installment,2007,1,1,1.0,1.0,0,0.0,1,1.0
bill_installment,2009,1,1,1.0,1.0,0,0.0,1,1.0
bill_installment,2010,4,2,0.5,0.0,2,0.5,0,0.0
bill_installment,2012,1,0,0.0,NULL,0,0.0,0,0.0
bill_installment,2013,3,2,0.666666666667,1.0,0,0.0,2,0.666666666667
bill_installment,2014,1,0,0.0,NULL,0,0.0,0,0.0
bill_installment,2015,1,1,1.0,1.0,0,0.0,1,1.0
bill_installment,2017,1,0,0.0,NULL,0,0.0,0,0.0
bill_installment,2019,2,2,1.0,0.0,2,1.0,0,0.0
bill_installment,2020,1,1,1.0,1.0,0,0.0,1,1.0
bill_installment,2021,1,0,0.0,NULL,0,0.0,0,0.0
bill_installment,2022,2,1,0.5,0.0,1,0.5,0,0.0
bill_installment,2023,1,0,0.0,NULL,0,0.0,0,0.0
bill_installment,2026,2,2,1.0,0.5,1,0.5,1,0.5
bill_installment,2027,2,1,0.5,0.0,1,0.5,0,0.0
bill_installment,2029,2,1,0.5,1.0,0,0.0,1,0.5
bill_installment,2030,2,2,1.0,1.0,0,0.0,2,1.0
bill_installment,2032,3,2,0.666666666667,1.0,0,0.0,2,0.666666666667
bill_installment,2034,2,1,0.5,1.0,0,0.0,1,0.5
bill_installment,2035,1,1,1.0,0.0,1,1.0,0,0.0
bill_installment,2036,1,0,0.0,NULL,0,0.0,0,0.0
bill_installment,2037,1,1,1.0,0.0,1,1.0,0,0.0
bill_installment,2038,1,1,1.0,0.0,1,1.0,0,0.0
bill_installment,2042,2,1,0.5,1.0,0,0.0,1,0.5
bill_installment,2043,2,0,0.0,NULL,0,0.0,0,0.0
bill_installment,2044,1,1,1.0,1.0,0,0.0,1,1.0
bill_installment,2046,1,1,1.0,0.0,1,1.0,0,0.0
bill_installment,2047,1,0,0.0,NULL,0,0.0,0,0.0
bill_installment,2048,1,0,0.0,NULL,0,0.0,0,0.0
bill_installment,2049,2,1,0.5,1.0,0,0.0,1,0.5
bill_installment,2051,1,1,1.0,1.0,0,0.0,1,1.0
bill_installment,2052,1,0,0.0,NULL,0,0.0,0,0.0
bill_installment,2055,1,1,1.0,1.0,0,0.0,1,1.0
bill_installment,2056,2,1,0.5,1.0,0,0.0,1,0.5
bill_installment,2057,2,2,1.0,1.0,0,0.0,2,1.0
bill_installment,2060,1,0,0.0,NULL,0,0.0,0,0.0
bill_installment,2061,2,2,1.0,0.0,2,1.0,0,0.0
bill_installment,2063,1,1,1.0,1.0,0,0.0,1,1.0
bill_installment,2065,2,1,0.5,0.0,1,0.5,0,0.0
bill_installment,2066,1,1,1.0,1.0,0,0.0,1,1.0
bill_installment,2067,4,3,0.75,1.0,0,0.0,3,0.75
bill_installment,2069,1,1,1.0,1.0,0,0.0,1,1.0
bill_installment,2071,4,4,1.0,1.0,0,0.0,4,1.0
bill_installment,2072,1,0,0.0,NULL,0,0.0,0,0.0
bill_installment,2073,3,1,0.333333333333,0.0,1,0.333333333333,0,0.0
bill_installment,2074,3,3,1.0,0.666666666667,1,0.333333333333,2,0.666666666667
bill_installment,2076,3,2,0.666666666667,1.0,0,0.0,2,0.666666666667
bill_installment,2078,1,1,1.0,1.0,0,0.0,1,1.0
bill_installment,2080,1,1,1.0,1.0,0,0.0,1,1.0
bill_installment,2081,2,1,0.5,0.0,1,0.5,0,0.0
bill_installment,2082,5,3,0.6,0.666666666667,1,0.2,2,0.4
bill_installment,2084,3,2,0.666666666667,0.5,1,0.333333333333,1,0.333333333333
bill_installment,2085,2,2,1.0,1.0,0,0.0,2,1.0
bill_installment,2087,2,1,0.5,1.0,0,0.0,1,0.5
bill_installment,2088,1,1,1.0,1.0,0,0.0,1,1.0
bill_installment,2090,3,2,0.666666666667,0.5,1,0.333333333333,1,0.333333333333
bill_installment,2092,1,1,1.0,1.0,0,0.0,1,1.0
bill_installment,2093,1,1,1.0,1.0,0,0.0,1,1.0
bill_installment,2094,1,0,0.0,NULL,0,0.0,0,0.0
bill_installment,2095,2,2,1.0,1.0,0,0.0,2,1.0
bill_installment,2096,1,0,0.0,NULL,0,0.0,0,0.0
bill_installment,2097,1,0,0.0,NULL,0,0.0,0,0.0
bill_installment,2098,3,2,0.666666666667,1.0,0,0.0,2,0.666666666667
bill_installment,2099,1,0,0.0,NULL,0,0.0,0,0.0
bill_installment,2100,1,0,0.0,NULL,0,0.0,0,0.0
bill_installment,2101,1,1,1.0,0.0,1,1.0,0,0.0
bill_installment,2102,1,1,1.0,1.0,0,0.0,1,1.0
bill_installment,2103,1,1,1.0,1.0,0,0.0,1,1.0
bill_installment,2104,2,0,0.0,NULL,0,0.0,0,0.0
bill_installment,2106,2,1,0.5,1.0,0,0.0,1,0.5
bill_installment,2109,2,1,0.5,0.0,1,0.5,0,0.0
bill_installment,2110,3,1,0.333333333333,1.0,0,0.0,1,0.333333333333
bill_installment,2111,2,0,0.0,NULL,0,0.0,0,0.0
bill_installment,2113,1,1,1.0,1.0,0,0.0,1,1.0
bill_installment,2114,2,1,0.5,1.0,0,0.0,1,0.5
bill_installment,2115,1,1,1.0,0.0,1,1.0,0,0.0
bill_installment,2116,1,1,1.0,1.0,0,0.0,1,1.0
bill_installment,2117,1,0,0.0,NULL,0,0.0,0,0.0
bill_installment,2118,1,0,0.0,NULL,0,0.0,0,0.0
bill_installment,2119,1,0,0.0,NULL,0,0.0,0,0.0
bill_installment,2120,1,1,1.0,1.0,0,0.0,1,1.0
bill_installment,2121,2,0,0.0,NULL,0,0.0,0,0.0
bill_installment,2122,1,0,0.0,NULL,0,0.0,0,0.0
bill_installment,2123,2,0,0.0,NULL,0,0.0,0,0.0
bill_installment,2125,1,0,0.0,NULL,0,0.0,0,0.0
bill_installment,2128,2,1,0.5,1.0,0,0.0,1,0.5
bill_installment,2129,2,1,0.5,1.0,0,0.0,1,0.5
bill_installment,2131,1,0,0.0,NULL,0,0.0,0,0.0
bill_installment,2140,2,0,0.0,NULL,0,0.0,0,0.0
bill_installment,2141,2,1,0.5,1.0,0,0.0,1,0.5
bill_installment,2142,1,0,0.0,NULL,0,0.0,0,0.0
bill_installment,2143,1,1,1.0,1.0,0,0.0,1,1.0
bill_installment,2144,2,1,0.5,1.0,0,0.0,1,0.5
bill_installment,2145,1,1,1.0,1.0,0,0.0,1,1.0
bill_installment,2147,2,1,0.5,1.0,0,0.0,1,0.5
bill_installment,2152,3,2,0.666666666667,1.0,0,0.0,2,0.666666666667
bill_installment,2155,1,0,0.0,NULL,0,0.0,0,0.0
bill_installment,2157,2,2,1.0,1.0,0,0.0,2,1.0
bill_installment,2158,1,0,0.0,NULL,0,0.0,0,0.0
bill_installment,2160,1,0,0.0,NULL,0,0.0,0,0.0
bill_installment,2163,1,1,1.0,1.0,0,0.0,1,1.0
bill_installment,2164,1,0,0.0,NULL,0,0.0,0,0.0
bill_installment,2166,1,1,1.0,0.0,1,1.0,0,0.0
bill_installment,2167,1,0,0.0,NULL,0,0.0,0,0.0
bill_installment,2169,1,1,1.0,1.0,0,0.0,1,1.0
bill_installment,2170,2,2,1.0,0.5,1,0.5,1,0.5
bill_installment,2173,2,2,1.0,1.0,0,0.0,2,1.0
bill_installment,2174,2,2,1.0,1.0,0,0.0,2,1.0
bill_installment,2175,2,2,1.0,1.0,0,0.0,2,1.0
bill_installment,2176,1,0,0.0,NULL,0,0.0,0,0.0
bill_installment,2178,1,0,0.0,NULL,0,0.0,0,0.0
bill_installment,2179,1,1,1.0,1.0,0,0.0,1,1.0
bill_installment,2181,1,0,0.0,NULL,0,0.0,0,0.0
bill_installment,2182,1,0,0.0,NULL,0,0.0,0,0.0
bill_installment,2183,1,0,0.0,NULL,0,0.0,0,0.0
bill_installment,2188,2,2,1.0,0.5,1,0.5,1,0.5
bill_installment,2189,1,1,1.0,1.0,0,0.0,1,1.0
bill_installment,2193,1,1,1.0,1.0,0,0.0,1,1.0
bill_installment,2197,1,1,1.0,1.0,0,0.0,1,1.0
bill_installment,2199,3,3,1.0,1.0,0,0.0,3,1.0
bill_installment,2200,3,1,0.333333333333,1.0,0,0.0,1,0.333333333333
bill_installment,2202,1,1,1.0,0.0,1,1.0,0,0.0
bill_installment,2204,2,1,0.5,1.0,0,0.0,1,0.5
bill_installment,2205,1,1,1.0,0.0,1,1.0,0,0.0
bill_installment,2206,1,0,0.0,NULL,0,0.0,0,0.0
bill_installment,2209,2,2,1.0,1.0,0,0.0,2,1.0
bill_installment,2210,1,1,1.0,1.0,0,0.0,1,1.0
bill_installment,2211,1,1,1.0,0.0,1,1.0,0,0.0
bill_installment,2213,1,1,1.0,1.0,0,0.0,1,1.0
bill_installment,2220,1,1,1.0,0.0,1,1.0,0,0.0
bill_installment,2222,2,2,1.0,1.0,0,0.0,2,1.0
bill_installment,2225,1,1,1.0,1.0,0,0.0,1,1.0
bill_installment,2229,1,1,1.0,1.0,0,0.0,1,1.0
bill_installment,2230,2,2,1.0,1.0,0,0.0,2,1.0
bill_installment,2231,1,1,1.0,0.0,1,1.0,0,0.0
bill_installment,2232,1,1,1.0,1.0,0,0.0,1,1.0
bill_installment,2233,2,1,0.5,1.0,0,0.0,1,0.5
bill_installment,2234,1,0,0.0,NULL,0,0.0,0,0.0
bill_installment,2235,2,1,0.5,1.0,0,0.0,1,0.5
bill_installment,2236,1,0,0.0,NULL,0,0.0,0,0.0
bill_installment,2237,3,2,0.666666666667,0.0,2,0.666666666667,0,0.0
bill_installment,2239,1,1,1.0,1.0,0,0.0,1,1.0
bill_installment,2244,1,0,0.0,NULL,0,0.0,0,0.0
bill_installment,2245,1,1,1.0,1.0,0,0.0,1,1.0
bill_installment,2246,1,1,1.0,1.0,0,0.0,1,1.0
bill_installment,2247,1,0,0.0,NULL,0,0.0,0,0.0
bill_installment,2249,1,0,0.0,NULL,0,0.0,0,0.0
bill_installment,2250,1,0,0.0,NULL,0,0.0,0,0.0
bill_installment,2251,1,0,0.0,NULL,0,0.0,0,0.0
bill_installment,2252,3,3,1.0,1.0,0,0.0,3,1.0
bill_installment,2253,1,0,0.0,NULL,0,0.0,0,0.0
bill_installment,2254,2,0,0.0,NULL,0,0.0,0,0.0
bill_installment,2255,2,2,1.0,1.0,0,0.0,2,1.0
bill_installment,2257,1,0,0.0,NULL,0,0.0,0,0.0
bill_installment,2261,1,1,1.0,1.0,0,0.0,1,1.0
bill_installment,2264,1,1,1.0,1.0,0,0.0,1,1.0
bill_installment,2268,1,1,1.0,1.0,0,0.0,1,1.0
bill_installment,2270,1,1,1.0,1.0,0,0.0,1,1.0
bill_installment,2272,1,0,0.0,NULL,0,0.0,0,0.0
bill_installment,2276,1,0,0.0,NULL,0,0.0,0,0.0
bill_installment,2277,2,2,1.0,1.0,0,0.0,2,1.0
bill_installment,2279,2,2,1.0,0.5,1,0.5,1,0.5
bill_installment,2282,2,2,1.0,0.5,1,0.5,1,0.5
bill_installment,2283,1,1,1.0,1.0,0,0.0,1,1.0
bill_installment,2284,2,1,0.5,1.0,0,0.0,1,0.5
bill_installment,2286,2,1,0.5,0.0,1,0.5,0,0.0
bill_installment,2287,1,1,1.0,0.0,1,1.0,0,0.0
bill_installment,2288,1,0,0.0,NULL,0,0.0,0,0.0
bill_installment,2289,2,1,0.5,1.0,0,0.0,1,0.5
bill_installment,2291,1,1,1.0,1.0,0,0.0,1,1.0
bill_installment,2292,2,1,0.5,1.0,0,0.0,1,0.5
bill_installment,2293,2,1,0.5,0.0,1,0.5,0,0.0
bill_installment,2294,1,1,1.0,1.0,0,0.0,1,1.0
bill_installment,2295,1,0,0.0,NULL,0,0.0,0,0.0
bill_installment,2297,2,2,1.0,1.0,0,0.0,2,1.0
bill_installment,2299,1,0,0.0,NULL,0,0.0,0,0.0
bill_installment,2301,3,3,1.0,0.333333333333,2,0.666666666667,1,0.333333333333
bill_installment,2304,1,1,1.0,1.0,0,0.0,1,1.0
bill_installment,2307,1,0,0.0,NULL,0,0.0,0,0.0
bill_installment,2309,1,0,0.0,NULL,0,0.0,0,0.0
bill_installment,2310,1,1,1.0,1.0,0,0.0,1,1.0
bill_installment,2312,1,1,1.0,1.0,0,0.0,1,1.0
bill_installment,2314,1,0,0.0,NULL,0,0.0,0,0.0
bill_installment,2315,1,0,0.0,NULL,0,0.0,0,0.0
bill_installment,2317,1,0,0.0,NULL,0,0.0,0,0.0
bill_installment,2321,2,1,0.5,0.0,1,0.5,0,0.0
bill_installment,2323,1,1,1.0,1.0,0,0.0,1,1.0
bill_installment,2324,2,2,1.0,1.0,0,0.0,2,1.0
bill_installment,2325,2,1,0.5,0.0,1,0.5,0,0.0
bill_installment,2327,1,0,0.0,NULL,0,0.0,0,0.0
bill_installment,2331,1,1,1.0,1.0,0,0.0,1,1.0
bill_installment,2333,1,0,0.0,NULL,0,0.0,0,0.0
bill_installment,2337,1,1,1.0,1.0,0,0.0,1,1.0
bill_installment,2340,1,0,0.0,NULL,0,0.0,0,0.0
bill_installment,2341,1,1,1.0,1.0,0,0.0,1,1.0
bill_installment,2343,2,1,0.5,1.0,0,0.0,1,0.5
bill_installment,2346,1,1,1.0,1.0,0,0.0,1,1.0
bill_installment,2347,1,1,1.0,1.0,0,0.0,1,1.0
bill_installment,2357,1,1,1.0,0.0,1,1.0,0,0.0
bill_installment,2359,1,0,0.0,NULL,0,0.0,0,0.0
bill_installment,2360,1,1,1.0,1.0,0,0.0,1,1.0
bill_installment,2363,1,1,1.0,0.0,1,1.0,0,0.0
bill_installment,2365,1,1,1.0,1.0,0,0.0,1,1.0
bill_installment,2367,1,1,1.0,1.0,0,0.0,1,1.0
bill_installment,2370,2,1,0.5,1.0,0,0.0,1,0.5
bill_installment,2376,1,0,0.0,NULL,0,0.0,0,0.0
bill_installment,2377,1,1,1.0,1.0,0,0.0,1,1.0
bill_installment,2379,1,0,0.0,NULL,0,0.0,0,0.0
bill_installment,2380,1,1,1.0,1.0,0,0.0,1,1.0
bill_installment,2382,1,1,1.0,1.0,0,0.0,1,1.0
bill_installment,2383,1,0,0.0,NULL,0,0.0,0,0.0
bill_installment,2384,1,0,0.0,NULL,0,0.0,0,0.0
bill_installment,2385,2,1,0.5,1.0,0,0.0,1,0.5
bill_installment,2386,1,1,1.0,1.0,0,0.0,1,1.0
bill_installment,2387,1,1,1.0,1.0,0,0.0,1,1.0
bill_installment,2388,1,0,0.0,NULL,0,0.0,0,0.0
bill_installment,2390,1,1,1.0,1.0,0,0.0,1,1.0
bill_installment,2393,1,1,1.0,1.0,0,0.0,1,1.0
bill_installment,2397,1,1,1.0,1.0,0,0.0,1,1.0
bill_installment,2400,2,0,0.0,NULL,0,0.0,0,0.0
bill_installment,2402,1,1,1.0,1.0,0,0.0,1,1.0
bill_installment,2403,1,1,1.0,0.0,1,1.0,0,0.0
bill_installment,2404,1,1,1.0,1.0,0,0.0,1,1.0
bill_installment,2406,2,1,0.5,1.0,0,0.0,1,0.5
bill_installment,2408,1,0,0.0,NULL,0,0.0,0,0.0
bill_installment,2409,3,2,0.666666666667,1.0,0,0.0,2,0.666666666667
bill_installment,2411,2,1,0.5,1.0,0,0.0,1,0.5
bill_installment,2414,1,0,0.0,NULL,0,0.0,0,0.0
bill_installment,2415,2,2,1.0,0.5,1,0.5,1,0.5
bill_installment,2416,1,0,0.0,NULL,0,0.0,0,0.0
bill_installment,2419,1,0,0.0,NULL,0,0.0,0,0.0
bill_installment,2421,1,1,1.0,1.0,0,0.0,1,1.0
bill_installment,2422,2,1,0.5,1.0,0,0.0,1,0.5
bill_installment,2426,2,2,1.0,1.0,0,0.0,2,1.0
bill_installment,2427,1,1,1.0,1.0,0,0.0,1,1.0
bill_installment,2428,1,0,0.0,NULL,0,0.0,0,0.0
bill_installment,2429,1,1,1.0,1.0,0,0.0,1,1.0
bill_installment,2430,1,1,1.0,1.0,0,0.0,1,1.0
bill_installment,2431,2,1,0.5,0.0,1,0.5,0,0.0
bill_installment,2436,2,1,0.5,1.0,0,0.0,1,0.5
bill_installment,2438,1,1,1.0,1.0,0,0.0,1,1.0
bill_installment,2444,1,0,0.0,NULL,0,0.0,0,0.0
bill_installment,2446,1,0,0.0,NULL,0,0.0,0,0.0
bill_installment,2447,1,0,0.0,NULL,0,0.0,0,0.0
bill_installment,2449,1,1,1.0,0.0,1,1.0,0,0.0
bill_installment,2452,1,1,1.0,1.0,0,0.0,1,1.0
bill_installment,2453,1,1,1.0,1.0,0,0.0,1,1.0
bill_installment,2455,1,0,0.0,NULL,0,0.0,0,0.0
bill_installment,2457,1,1,1.0,1.0,0,0.0,1,1.0
bill_installment,2458,2,0,0.0,NULL,0,0.0,0,0.0
bill_installment,2460,1,1,1.0,1.0,0,0.0,1,1.0
bill_installment,2461,1,0,0.0,NULL,0,0.0,0,0.0
bill_installment,2464,1,1,1.0,0.0,1,1.0,0,0.0
bill_installment,2465,1,0,0.0,NULL,0,0.0,0,0.0
bill_installment,2468,1,1,1.0,1.0,0,0.0,1,1.0
bill_installment,2470,2,2,1.0,1.0,0,0.0,2,1.0
bill_installment,2473,1,0,0.0,NULL,0,0.0,0,0.0
bill_installment,2476,1,0,0.0,NULL,0,0.0,0,0.0
bill_installment,2477,1,0,0.0,NULL,0,0.0,0,0.0
bill_installment,2479,1,1,1.0,1.0,0,0.0,1,1.0
bill_installment,2480,1,1,1.0,1.0,0,0.0,1,1.0
bill_installment,2482,1,1,1.0,0.0,1,1.0,0,0.0
bill_installment,2483,1,0,0.0,NULL,0,0.0,0,0.0
bill_installment,2486,2,1,0.5,1.0,0,0.0,1,0.5
bill_installment,2489,2,1,0.5,1.0,0,0.0,1,0.5
bill_installment,2490,1,1,1.0,0.0,1,1.0,0,0.0
bill_installment,2493,1,1,1.0,1.0,0,0.0,1,1.0
bill_installment,2496,1,0,0.0,NULL,0,0.0,0,0.0
bill_installment,2500,1,1,1.0,1.0,0,0.0,1,1.0
bill_installment,2502,2,2,1.0,1.0,0,0.0,2,1.0
bill_installment,2503,1,0,0.0,NULL,0,0.0,0,0.0
bill_installment,2506,2,1,0.5,1.0,0,0.0,1,0.5
bill_installment,2507,1,0,0.0,NULL,0,0.0,0,0.0
bill_installment,2511,1,1,1.0,0.0,1,1.0,0,0.0
bill_installment,2512,1,1,1.0,0.0,1,1.0,0,0.0
bill_installment,2513,2,1,0.5,0.0,1,0.5,0,0.0
bill_installment,2514,1,0,0.0,NULL,0,0.0,0,0.0
bill_installment,2517,1,1,1.0,0.0,1,1.0,0,0.0
bill_installment,2524,1,0,0.0,NULL,0,0.0,0,0.0
bill_installment,2527,1,0,0.0,NULL,0,0.0,0,0.0
bill_installment,2532,1,1,1.0,1.0,0,0.0,1,1.0
bill_installment,2533,1,1,1.0,0.0,1,1.0,0,0.0
bill_installment,2534,1,0,0.0,NULL,0,0.0,0,0.0
bill_installment,2535,2,0,0.0,NULL,0,0.0,0,0.0
bill_installment,2537,1,0,0.0,NULL,0,0.0,0,0.0
bill_installment,2538,1,0,0.0,NULL,0,0.0,0,0.0
bill_installment,2540,1,1,1.0,1.0,0,0.0,1,1.0
bill_installment,2542,1,0,0.0,NULL,0,0.0,0,0.0
bill_installment,2544,2,1,0.5,1.0,0,0.0,1,0.5
bill_installment,2545,1,1,1.0,1.0,0,0.0,1,1.0
bill_installment,2553,2,1,0.5,1.0,0,0.0,1,0.5
bill_installment,2554,2,0,0.0,NULL,0,0.0,0,0.0
bill_installment,2557,1,0,0.0,NULL,0,0.0,0,0.0
bill_installment,2558,1,0,0.0,NULL,0,0.0,0,0.0
bill_installment,2560,1,1,1.0,1.0,0,0.0,1,1.0
bill_installment,2561,1,1,1.0,1.0,0,0.0,1,1.0
bill_installment,2566,1,1,1.0,1.0,0,0.0,1,1.0
bill_installment,2571,1,1,1.0,1.0,0,0.0,1,1.0
bill_installment,2572,1,1,1.0,0.0,1,1.0,0,0.0
bill_installment,2574,2,1,0.5,1.0,0,0.0,1,0.5
bill_installment,2575,1,1,1.0,1.0,0,0.0,1,1.0
bill_installment,2576,1,0,0.0,NULL,0,0.0,0,0.0
bill_installment,2579,1,1,1.0,1.0,0,0.0,1,1.0
bill_installment,2583,1,1,1.0,1.0,0,0.0,1,1.0
bill_installment,2586,2,0,0.0,NULL,0,0.0,0,0.0
bill_installment,2590,1,0,0.0,NULL,0,0.0,0,0.0
bill_installment,2598,1,1,1.0,1.0,0,0.0,1,1.0
bill_installment,2601,1,1,1.0,0.0,1,1.0,0,0.0
bill_installment,2603,3,2,0.666666666667,1.0,0,0.0,2,0.666666666667
bill_installment,2606,1,0,0.0,NULL,0,0.0,0,0.0
bill_installment,2608,1,0,0.0,NULL,0,0.0,0,0.0
bill_installment,2609,1,0,0.0,NULL,0,0.0,0,0.0
bill_installment,2610,1,0,0.0,NULL,0,0.0,0,0.0
bill_installment,2612,1,0,0.0,NULL,0,0.0,0,0.0
bill_installment,2613,1,0,0.0,NULL,0,0.0,0,0.0
bill_installment,2617,1,0,0.0,NULL,0,0.0,0,0.0
bill_installment,2624,1,0,0.0,NULL,0,0.0,0,0.0
bill_installment,2625,2,1,0.5,1.0,0,0.0,1,0.5
bill_installment,2632,1,1,1.0,1.0,0,0.0,1,1.0
bill_installment,2634,1,1,1.0,0.0,1,1.0,0,0.0
bill_installment,2635,1,1,1.0,1.0,0,0.0,1,1.0
bill_installment,2638,1,1,1.0,1.0,0,0.0,1,1.0
bill_installment,2639,1,0,0.0,NULL,0,0.0,0,0.0
bill_installment,2641,1,0,0.0,NULL,0,0.0,0,0.0
bill_installment,2643,1,0,0.0,NULL,0,0.0,0,0.0
bill_installment,2644,1,1,1.0,1.0,0,0.0,1,1.0
bill_installment,2647,1,1,1.0,1.0,0,0.0,1,1.0
bill_installment,2648,1,1,1.0,1.0,0,0.0,1,1.0
bill_installment,2649,1,1,1.0,1.0,0,0.0,1,1.0
bill_installment,2650,1,0,0.0,NULL,0,0.0,0,0.0
bill_installment,2651,1,0,0.0,NULL,0,0.0,0,0.0
bill_installment,2655,1,1,1.0,1.0,0,0.0,1,1.0
bill_installment,2659,1,0,0.0,NULL,0,0.0,0,0.0
bill_installment,2660,1,1,1.0,1.0,0,0.0,1,1.0
bill_installment,2664,1,1,1.0,1.0,0,0.0,1,1.0
bill_installment,2668,2,2,1.0,0.5,1,0.5,1,0.5
bill_installment,2674,1,1,1.0,0.0,1,1.0,0,0.0
bill_installment,2676,1,1,1.0,1.0,0,0.0,1,1.0
bill_installment,2679,1,1,1.0,1.0,0,0.0,1,1.0
bill_installment,2683,1,0,0.0,NULL,0,0.0,0,0.0
bill_installment,2685,1,1,1.0,1.0,0,0.0,1,1.0
bill_installment,2686,1,0,0.0,NULL,0,0.0,0,0.0
bill_installment,2688,1,0,0.0,NULL,0,0.0,0,0.0
bill_installment,2689,2,2,1.0,0.5,1,0.5,1,0.5
bill_installment,2692,1,1,1.0,1.0,0,0.0,1,1.0
bill_installment,2693,1,1,1.0,1.0,0,0.0,1,1.0
bill_installment,2696,1,0,0.0,NULL,0,0.0,0,0.0
bill_installment,2698,2,0,0.0,NULL,0,0.0,0,0.0
bill_installment,2700,1,1,1.0,1.0,0,0.0,1,1.0
bill_installment,2701,1,0,0.0,NULL,0,0.0,0,0.0
bill_installment,2704,3,0,0.0,NULL,0,0.0,0,0.0
bill_installment,2706,1,0,0.0,NULL,0,0.0,0,0.0
bill_installment,2711,1,0,0.0,NULL,0,0.0,0,0.0
bill_installment,2713,1,1,1.0,1.0,0,0.0,1,1.0
bill_installment,2721,1,0,0.0,NULL,0,0.0,0,0.0
bill_installment,2727,2,1,0.5,0.0,1,0.5,0,0.0
bill_installment,2731,1,0,0.0,NULL,0,0.0,0,0.0
bill_installment,2739,2,2,1.0,1.0,0,0.0,2,1.0
bill_installment,2743,1,0,0.0,NULL,0,0.0,0,0.0
bill_installment,2746,1,1,1.0,1.0,0,0.0,1,1.0
bill_installment,2752,1,1,1.0,1.0,0,0.0,1,1.0
bill_installment,2753,1,1,1.0,1.0,0,0.0,1,1.0
bill_installment,2759,1,1,1.0,1.0,0,0.0,1,1.0
bill_installment,2766,1,0,0.0,NULL,0,0.0,0,0.0
bill_installment,2768,2,1,0.5,1.0,0,0.0,1,0.5
bill_installment,2770,1,0,0.0,NULL,0,0.0,0,0.0
bill_installment,2772,1,1,1.0,0.0,1,1.0,0,0.0
bill_installment,2775,1,0,0.0,NULL,0,0.0,0,0.0
bill_installment,2779,1,1,1.0,1.0,0,0.0,1,1.0
bill_installment,2787,1,1,1.0,1.0,0,0.0,1,1.0
bill_installment,2789,1,1,1.0,1.0,0,0.0,1,1.0
bill_installment,2790,2,0,0.0,NULL,0,0.0,0,0.0
bill_installment,2791,1,1,1.0,1.0,0,0.0,1,1.0
bill_installment,2793,1,1,1.0,1.0,0,0.0,1,1.0
bill_installment,2794,1,0,0.0,NULL,0,0.0,0,0.0
bill_installment,2799,1,0,0.0,NULL,0,0.0,0,0.0
bill_installment,2801,2,0,0.0,NULL,0,0.0,0,0.0
bill_installment,2802,1,1,1.0,1.0,0,0.0,1,1.0
bill_installment,2805,1,1,1.0,0.0,1,1.0,0,0.0
bill_installment,2813,1,1,1.0,1.0,0,0.0,1,1.0
bill_installment,2817,1,1,1.0,1.0,0,0.0,1,1.0
bill_installment,2819,1,1,1.0,0.0,1,1.0,0,0.0
bill_installment,2826,1,0,0.0,NULL,0,0.0,0,0.0
bill_installment,2827,1,1,1.0,0.0,1,1.0,0,0.0
bill_installment,2831,1,1,1.0,1.0,0,0.0,1,1.0
bill_installment,2833,1,1,1.0,1.0,0,0.0,1,1.0
bill_installment,2835,1,1,1.0,1.0,0,0.0,1,1.0
bill_installment,2842,1,1,1.0,1.0,0,0.0,1,1.0
bill_installment,2849,1,1,1.0,1.0,0,0.0,1,1.0
bill_installment,2856,1,0,0.0,NULL,0,0.0,0,0.0
bill_installment,2862,1,1,1.0,0.0,1,1.0,0,0.0
bill_installment,2866,1,0,0.0,NULL,0,0.0,0,0.0
bill_installment,2868,1,0,0.0,NULL,0,0.0,0,0.0
bill_installment,2872,1,1,1.0,1.0,0,0.0,1,1.0
bill_installment,2875,1,0,0.0,NULL,0,0.0,0,0.0
bill_installment,2876,2,2,1.0,1.0,0,0.0,2,1.0
bill_installment,2880,1,1,1.0,0.0,1,1.0,0,0.0
bill_installment,2881,1,0,0.0,NULL,0,0.0,0,0.0
bill_installment,2882,1,0,0.0,NULL,0,0.0,0,0.0
bill_installment,2883,1,1,1.0,0.0,1,1.0,0,0.0
bill_installment,2884,1,1,1.0,1.0,0,0.0,1,1.0
bill_installment,2885,2,1,0.5,1.0,0,0.0,1,0.5
bill_installment,2886,2,0,0.0,NULL,0,0.0,0,0.0
bill_installment,2896,1,1,1.0,1.0,0,0.0,1,1.0
bill_installment,2909,1,1,1.0,1.0,0,0.0,1,1.0
bill_installment,2913,1,1,1.0,1.0,0,0.0,1,1.0
bill_installment,2923,1,1,1.0,0.0,1,1.0,0,0.0
bill_installment,2928,1,1,1.0,1.0,0,0.0,1,1.0
bill_installment,2931,1,0,0.0,NULL,0,0.0,0,0.0
bill_installment,2937,1,0,0.0,NULL,0,0.0,0,0.0
bill_installment,2938,1,1,1.0,0.0,1,1.0,0,0.0
bill_installment,2949,1,1,1.0,1.0,0,0.0,1,1.0
bill_installment,2953,1,0,0.0,NULL,0,0.0,0,0.0
bill_installment,2957,1,0,0.0,NULL,0,0.0,0,0.0
bill_installment,2958,1,1,1.0,1.0,0,0.0,1,1.0
bill_installment,2960,1,1,1.0,1.0,0,0.0,1,1.0
bill_installment,2961,1,1,1.0,1.0,0,0.0,1,1.0
bill_installment,2965,1,1,1.0,0.0,1,1.0,0,0.0
bill_installment,2971,1,1,1.0,1.0,0,0.0,1,1.0
bill_installment,2978,1,1,1.0,1.0,0,0.0,1,1.0
bill_installment,2979,2,0,0.0,NULL,0,0.0,0,0.0
bill_installment,2982,1,0,0.0,NULL,0,0.0,0,0.0
bill_installment,2985,1,0,0.0,NULL,0,0.0,0,0.0
bill_installment,2992,1,0,0.0,NULL,0,0.0,0,0.0
bill_installment,2996,1,1,1.0,1.0,0,0.0,1,1.0
bill_installment,3001,1,1,1.0,1.0,0,0.0,1,1.0
bill_installment,3005,1,0,0.0,NULL,0,0.0,0,0.0
bill_installment,3007,1,1,1.0,0.0,1,1.0,0,0.0
bill_installment,3010,2,2,1.0,1.0,0,0.0,2,1.0
bill_installment,3012,1,1,1.0,1.0,0,0.0,1,1.0
bill_installment,3017,1,0,0.0,NULL,0,0.0,0,0.0
bill_installment,3018,1,0,0.0,NULL,0,0.0,0,0.0
bill_installment,3025,1,0,0.0,NULL,0,0.0,0,0.0
bill_installment,3033,1,0,0.0,NULL,0,0.0,0,0.0
bill_installment,3035,2,1,0.5,1.0,0,0.0,1,0.5
bill_installment,3037,1,1,1.0,1.0,0,0.0,1,1.0
bill_installment,3040,1,1,1.0,1.0,0,0.0,1,1.0
bill_installment,3048,1,0,0.0,NULL,0,0.0,0,0.0
bill_installment,3050,1,1,1.0,0.0,1,1.0,0,0.0
bill_installment,3055,2,1,0.5,1.0,0,0.0,1,0.5
bill_installment,3059,1,0,0.0,NULL,0,0.0,0,0.0
bill_installment,3068,1,1,1.0,0.0,1,1.0,0,0.0
bill_installment,3070,1,0,0.0,NULL,0,0.0,0,0.0
bill_installment,3071,1,1,1.0,1.0,0,0.0,1,1.0
bill_installment,3080,1,0,0.0,NULL,0,0.0,0,0.0
bill_installment,3084,1,0,0.0,NULL,0,0.0,0,0.0
bill_installment,3092,1,1,1.0,1.0,0,0.0,1,1.0
bill_installment,3095,1,1,1.0,0.0,1,1.0,0,0.0
bill_installment,3102,1,1,1.0,0.0,1,1.0,0,0.0
bill_installment,3115,1,1,1.0,0.0,1,1.0,0,0.0
bill_installment,3116,1,1,1.0,0.0,1,1.0,0,0.0
bill_installment,3122,1,1,1.0,1.0,0,0.0,1,1.0
bill_installment,3125,1,0,0.0,NULL,0,0.0,0,0.0
bill_installment,3134,1,1,1.0,1.0,0,0.0,1,1.0
bill_installment,3156,1,0,0.0,NULL,0,0.0,0,0.0
bill_installment,3167,1,1,1.0,1.0,0,0.0,1,1.0
bill_installment,3179,2,0,0.0,NULL,0,0.0,0,0.0
bill_installment,3180,2,1,0.5,1.0,0,0.0,1,0.5
bill_installment,3184,1,1,1.0,1.0,0,0.0,1,1.0
bill_installment,3189,1,1,1.0,1.0,0,0.0,1,1.0
bill_installment,3199,1,0,0.0,NULL,0,0.0,0,0.0
bill_installment,3201,1,1,1.0,0.0,1,1.0,0,0.0
bill_installment,3206,2,2,1.0,0.5,1,0.5,1,0.5
bill_installment,3209,1,1,1.0,1.0,0,0.0,1,1.0
bill_installment,3211,1,1,1.0,1.0,0,0.0,1,1.0
bill_installment,3230,1,0,0.0,NULL,0,0.0,0,0.0
bill_installment,3237,1,1,1.0,1.0,0,0.0,1,1.0
bill_installment,3238,1,0,0.0,NULL,0,0.0,0,0.0
bill_installment,3254,1,0,0.0,NULL,0,0.0,0,0.0
bill_installment,3256,1,0,0.0,NULL,0,0.0,0,0.0
bill_installment,3257,1,1,1.0,1.0,0,0.0,1,1.0
bill_installment,3279,2,2,1.0,1.0,0,0.0,2,1.0
bill_installment,3284,1,1,1.0,1.0,0,0.0,1,1.0
bill_installment,3285,1,0,0.0,NULL,0,0.0,0,0.0
bill_installment,3290,1,0,0.0,NULL,0,0.0,0,0.0
bill_installment,3294,1,1,1.0,1.0,0,0.0,1,1.0
bill_installment,3303,1,0,0.0,NULL,0,0.0,0,0.0
bill_installment,3305,1,1,1.0,1.0,0,0.0,1,1.0
bill_installment,3310,1,0,0.0,NULL,0,0.0,0,0.0
bill_installment,3311,1,1,1.0,0.0,1,1.0,0,0.0
bill_installment,3314,1,0,0.0,NULL,0,0.0,0,0.0
bill_installment,3321,1,0,0.0,NULL,0,0.0,0,0.0
bill_installment,3326,1,1,1.0,0.0,1,1.0,0,0.0
bill_installment,3328,1,0,0.0,NULL,0,0.0,0,0.0
bill_installment,3350,1,1,1.0,0.0,1,1.0,0,0.0
bill_installment,3358,1,1,1.0,0.0,1,1.0,0,0.0
bill_installment,3368,1,0,0.0,NULL,0,0.0,0,0.0
bill_installment,3373,1,0,0.0,NULL,0,0.0,0,0.0
bill_installment,3376,1,1,1.0,1.0,0,0.0,1,1.0
bill_installment,3386,1,0,0.0,NULL,0,0.0,0,0.0
bill_installment,3392,1,1,1.0,1.0,0,0.0,1,1.0
bill_installment,3404,1,1,1.0,1.0,0,0.0,1,1.0
bill_installment,3420,1,1,1.0,1.0,0,0.0,1,1.0
bill_installment,3427,1,1,1.0,1.0,0,0.0,1,1.0
bill_installment,3437,1,1,1.0,0.0,1,1.0,0,0.0
bill_installment,3439,1,1,1.0,1.0,0,0.0,1,1.0
bill_installment,3448,1,0,0.0,NULL,0,0.0,0,0.0
bill_installment,3454,1,1,1.0,1.0,0,0.0,1,1.0
bill_installment,3456,1,1,1.0,0.0,1,1.0,0,0.0
bill_installment,3463,2,2,1.0,1.0,0,0.0,2,1.0
bill_installment,3479,1,1,1.0,1.0,0,0.0,1,1.0
bill_installment,3480,1,1,1.0,1.0,0,0.0,1,1.0
bill_installment,3481,1,0,0.0,NULL,0,0.0,0,0.0
bill_installment,3487,1,0,0.0,NULL,0,0.0,0,0.0
bill_installment,3492,1,1,1.0,1.0,0,0.0,1,1.0
bill_installment,3545,1,0,0.0,NULL,0,0.0,0,0.0
bill_installment,3552,1,0,0.0,NULL,0,0.0,0,0.0
bill_installment,3564,1,1,1.0,1.0,0,0.0,1,1.0
bill_installment,3572,1,0,0.0,NULL,0,0.0,0,0.0
bill_installment,3575,1,1,1.0,1.0,0,0.0,1,1.0
bill_installment,3577,1,1,1.0,1.0,0,0.0,1,1.0
bill_installment,3581,1,0,0.0,NULL,0,0.0,0,0.0
bill_installment,3601,1,1,1.0,1.0,0,0.0,1,1.0
bill_installment,3609,1,0,0.0,NULL,0,0.0,0,0.0
bill_installment,3629,1,1,1.0,1.0,0,0.0,1,1.0
bill_installment,3657,1,1,1.0,1.0,0,0.0,1,1.0
bill_installment,3661,1,0,0.0,NULL,0,0.0,0,0.0
bill_installment,3666,1,0,0.0,NULL,0,0.0,0,0.0
bill_installment,3694,2,0,0.0,NULL,0,0.0,0,0.0
bill_installment,3704,1,0,0.0,NULL,0,0.0,0,0.0
bill_installment,3727,1,0,0.0,NULL,0,0.0,0,0.0
bill_installment,3733,1,1,1.0,0.0,1,1.0,0,0.0
bill_installment,3739,1,0,0.0,NULL,0,0.0,0,0.0
bill_installment,3741,1,0,0.0,NULL,0,0.0,0,0.0
bill_installment,3796,1,0,0.0,NULL,0,0.0,0,0.0
bill_installment,3802,1,1,1.0,1.0,0,0.0,1,1.0
bill_installment,3804,1,0,0.0,NULL,0,0.0,0,0.0
bill_installment,3811,1,0,0.0,NULL,0,0.0,0,0.0
bill_installment,3830,1,1,1.0,0.0,1,1.0,0,0.0
bill_installment,3856,1,1,1.0,1.0,0,0.0,1,1.0
bill_installment,3862,1,1,1.0,1.0,0,0.0,1,1.0
bill_installment,3868,1,0,0.0,NULL,0,0.0,0,0.0
bill_installment,3872,1,0,0.0,NULL,0,0.0,0,0.0
bill_installment,3892,1,0,0.0,NULL,0,0.0,0,0.0
bill_installment,3896,1,0,0.0,NULL,0,0.0,0,0.0
bill_installment,3932,1,0,0.0,NULL,0,0.0,0,0.0
bill_installment,3937,1,0,0.0,NULL,0,0.0,0,0.0
bill_installment,3938,1,1,1.0,1.0,0,0.0,1,1.0
bill_installment,3939,1,0,0.0,NULL,0,0.0,0,0.0
bill_installment,3944,1,0,0.0,NULL,0,0.0,0,0.0
bill_installment,3949,1,1,1.0,1.0,0,0.0,1,1.0
bill_installment,3979,1,0,0.0,NULL,0,0.0,0,0.0
bill_installment,3984,1,0,0.0,NULL,0,0.0,0,0.0
bill_installment,3990,1,1,1.0,1.0,0,0.0,1,1.0
bill_installment,4010,1,1,1.0,1.0,0,0.0,1,1.0
bill_installment,4017,1,1,1.0,1.0,0,0.0,1,1.0
bill_installment,4040,1,1,1.0,1.0,0,0.0,1,1.0
bill_installment,4045,1,0,0.0,NULL,0,0.0,0,0.0
bill_installment,4056,1,1,1.0,1.0,0,0.0,1,1.0
bill_installment,4061,1,1,1.0,1.0,0,0.0,1,1.0
bill_installment,4071,1,0,0.0,NULL,0,0.0,0,0.0
bill_installment,4093,1,1,1.0,1.0,0,0.0,1,1.0
bill_installment,4095,1,0,0.0,NULL,0,0.0,0,0.0
bill_installment,4114,1,1,1.0,1.0,0,0.0,1,1.0
bill_installment,4135,1,1,1.0,1.0,0,0.0,1,1.0
bill_installment,4137,1,0,0.0,NULL,0,0.0,0,0.0
bill_installment,4144,1,1,1.0,1.0,0,0.0,1,1.0
bill_installment,4148,1,1,1.0,1.0,0,0.0,1,1.0
bill_installment,4158,1,1,1.0,1.0,0,0.0,1,1.0
bill_installment,4171,1,0,0.0,NULL,0,0.0,0,0.0
bill_installment,4175,1,0,0.0,NULL,0,0.0,0,0.0
bill_installment,4206,1,0,0.0,NULL,0,0.0,0,0.0
bill_installment,4217,1,0,0.0,NULL,0,0.0,0,0.0
bill_installment,4230,1,1,1.0,0.0,1,1.0,0,0.0
bill_installment,4255,1,1,1.0,0.0,1,1.0,0,0.0
bill_installment,4257,1,1,1.0,0.0,1,1.0,0,0.0
bill_installment,4270,2,0,0.0,NULL,0,0.0,0,0.0
bill_installment,4293,1,0,0.0,NULL,0,0.0,0,0.0
bill_installment,4301,2,1,0.5,1.0,0,0.0,1,0.5
bill_installment,4326,1,0,0.0,NULL,0,0.0,0,0.0
bill_installment,4343,1,0,0.0,NULL,0,0.0,0,0.0
bill_installment,4350,1,1,1.0,0.0,1,1.0,0,0.0
bill_installment,4369,1,0,0.0,NULL,0,0.0,0,0.0
bill_installment,4408,1,1,1.0,1.0,0,0.0,1,1.0
bill_installment,4426,1,0,0.0,NULL,0,0.0,0,0.0
bill_installment,4433,1,0,0.0,NULL,0,0.0,0,0.0
bill_installment,4442,1,1,1.0,0.0,1,1.0,0,0.0
bill_installment,4448,1,1,1.0,0.0,1,1.0,0,0.0
bill_installment,4465,1,0,0.0,NULL,0,0.0,0,0.0
bill_installment,4481,1,0,0.0,NULL,0,0.0,0,0.0
bill_installment,4530,1,0,0.0,NULL,0,0.0,0,0.0
bill_installment,4538,1,1,1.0,0.0,1,1.0,0,0.0
bill_installment,4565,1,0,0.0,NULL,0,0.0,0,0.0
bill_installment,4590,1,0,0.0,NULL,0,0.0,0,0.0
bill_installment,4608,1,0,0.0,NULL,0,0.0,0,0.0
bill_installment,4646,1,0,0.0,NULL,0,0.0,0,0.0
bill_installment,4700,1,0,0.0,NULL,0,0.0,0,0.0
bill_installment,4719,1,0,0.0,NULL,0,0.0,0,0.0
bill_installment,4736,1,1,1.0,1.0,0,0.0,1,1.0
bill_installment,4742,1,1,1.0,1.0,0,0.0,1,1.0
bill_installment,4748,1,1,1.0,1.0,0,0.0,1,1.0
bill_installment,4752,1,1,1.0,1.0,0,0.0,1,1.0
bill_installment,4820,1,1,1.0,1.0,0,0.0,1,1.0
bill_installment,4837,1,0,0.0,NULL,0,0.0,0,0.0
bill_installment,4864,1,1,1.0,0.0,1,1.0,0,0.0
bill_installment,4918,1,0,0.0,NULL,0,0.0,0,0.0
bill_installment,4919,1,0,0.0,NULL,0,0.0,0,0.0
bill_installment,4957,1,1,1.0,1.0,0,0.0,1,1.0
bill_installment,4972,1,1,1.0,0.0,1,1.0,0,0.0
bill_installment,5019,1,1,1.0,1.0,0,0.0,1,1.0
bill_installment,5048,1,1,1.0,1.0,0,0.0,1,1.0
bill_installment,5052,1,1,1.0,1.0,0,0.0,1,1.0
bill_installment,5055,1,1,1.0,1.0,0,0.0,1,1.0
bill_installment,5135,1,1,1.0,1.0,0,0.0,1,1.0
bill_installment,5142,1,0,0.0,NULL,0,0.0,0,0.0
bill_installment,5179,1,0,0.0,NULL,0,0.0,0,0.0
bill_installment,5181,1,1,1.0,1.0,0,0.0,1,1.0
bill_installment,5188,1,1,1.0,0.0,1,1.0,0,0.0
bill_installment,5193,1,1,1.0,1.0,0,0.0,1,1.0
bill_installment,5292,1,1,1.0,1.0,0,0.0,1,1.0
bill_installment,5366,1,0,0.0,NULL,0,0.0,0,0.0
bill_installment,5464,1,0,0.0,NULL,0,0.0,0,0.0
bill_installment,5477,1,1,1.0,0.0,1,1.0,0,0.0
bill_installment,5500,1,0,0.0,NULL,0,0.0,0,0.0
bill_installment,5515,1,1,1.0,1.0,0,0.0,1,1.0
bill_installment,5529,1,1,1.0,1.0,0,0.0,1,1.0
bill_installment,5537,1,1,1.0,1.0,0,0.0,1,1.0
bill_installment,5540,1,0,0.0,NULL,0,0.0,0,0.0
bill_installment,5550,1,0,0.0,NULL,0,0.0,0,0.0
bill_installment,5566,1,0,0.0,NULL,0,0.0,0,0.0
bill_installment,5614,1,0,0.0,NULL,0,0.0,0,0.0
bill_installment,5635,1,0,0.0,NULL,0,0.0,0,0.0
bill_installment,5673,1,1,1.0,1.0,0,0.0,1,1.0
bill_installment,5705,1,1,1.0,1.0,0,0.0,1,1.0
bill_installment,5724,1,0,0.0,NULL,0,0.0,0,0.0
bill_installment,5787,1,1,1.0,1.0,0,0.0,1,1.0
bill_installment,5805,1,1,1.0,0.0,1,1.0,0,0.0
bill_installment,5810,1,0,0.0,NULL,0,0.0,0,0.0
bill_installment,5839,1,0,0.0,NULL,0,0.0,0,0.0
bill_installment,5843,1,0,0.0,NULL,0,0.0,0,0.0
bill_installment,5937,1,0,0.0,NULL,0,0.0,0,0.0
bill_installment,5988,1,0,0.0,NULL,0,0.0,0,0.0
bill_installment,6005,1,0,0.0,NULL,0,0.0,0,0.0
bill_installment,6138,1,0,0.0,NULL,0,0.0,0,0.0
bill_installment,6316,1,1,1.0,1.0,0,0.0,1,1.0
bill_installment,6577,1,0,0.0,NULL,0,0.0,0,0.0
bill_installment,6700,1,1,1.0,0.0,1,1.0,0,0.0
bill_installment,6783,1,1,1.0,0.0,1,1.0,0,0.0
bill_installment,6804,1,1,1.0,1.0,0,0.0,1,1.0
bill_installment,6820,1,1,1.0,1.0,0,0.0,1,1.0
bill_installment,6896,1,1,1.0,1.0,0,0.0,1,1.0
bill_installment,6964,1,1,1.0,1.0,0,0.0,1,1.0
bill_installment,6965,1,1,1.0,1.0,0,0.0,1,1.0
bill_installment,6974,1,1,1.0,1.0,0,0.0,1,1.0
bill_installment,7237,1,1,1.0,1.0,0,0.0,1,1.0
bill_installment,7305,1,1,1.0,1.0,0,0.0,1,1.0
bill_installment,7307,1,0,0.0,NULL,0,0.0,0,0.0
bill_installment,7330,1,1,1.0,1.0,0,0.0,1,1.0
bill_installment,7780,1,0,0.0,NULL,0,0.0,0,0.0
bill_installment,7809,1,1,1.0,1.0,0,0.0,1,1.0
bill_installment,7814,1,0,0.0,NULL,0,0.0,0,0.0
bill_installment,7834,1,1,1.0,1.0,0,0.0,1,1.0
bill_installment,7895,1,1,1.0,0.0,1,1.0,0,0.0
bill_installment,8233,1,0,0.0,NULL,0,0.0,0,0.0
bill_installment,8999,1,0,0.0,NULL,0,0.0,0,0.0
bill_installment,9238,1,0,0.0,NULL,0,0.0,0,0.0
bill_installment,9273,1,0,0.0,NULL,0,0.0,0,0.0
bill_installment,9532,1,1,1.0,1.0,0,0.0,1,1.0
bill_installment,9819,1,0,0.0,NULL,0,0.0,0,0.0
bill_installment,10173,1,1,1.0,1.0,0,0.0,1,1.0
bill_installment,10794,1,0,0.0,NULL,0,0.0,0,0.0
bill_installment,10983,1,0,0.0,NULL,0,0.0,0,0.0
bill_installment,11368,1,1,1.0,0.0,1,1.0,0,0.0
bill_installment,11923,1,1,1.0,0.0,1,1.0,0,0.0
bill_installment,11993,1,0,0.0,NULL,0,0.0,0,0.0
car,0,4075744,228710,0.0561149081002,0.214275720345,179703,0.044090845745,49007,0.0120240623552
car,1,844080,67042,0.0794261207468,0.262089436473,49471,0.0586093735191,17571,0.0208167472278
car,2,510733,49503,0.096925399377,0.292648930368,35016,0.0685602849238,14487,0.0283651144531
car,3,326282,34381,0.105372040137,0.315086821209,23548,0.0721706989659,10833,0.0332013411711
car,4,250871,28952,0.115405925755,0.326333241227,19504,0.0777451359464,9448,0.0376607898083
car,5,186048,22743,0.122242647059,0.345600844216,14883,0.0799954850361,7860,0.0422471620227
car,6,155490,19931,0.128181876648,0.35863729868,12783,0.0822110746672,7148,0.0459708019808
car,7,122935,15986,0.130036197991,0.380020017515,9911,0.0806198397527,6075,0.0494163582381
car,8,105164,14183,0.134865543342,0.388211238807,8677,0.0825092236887,5506,0.0523563196531
car,9,87157,12301,0.141136110697,0.408015608487,7282,0.0835503746113,5019,0.0575857360855
car,10,76126,11041,0.145035861598,0.40467348972,6573,0.0863436933505,4468,0.0586921682474
car,11,64661,9522,0.147260326936,0.416194076875,5559,0.0859714511065,3963,0.0612888758293
car,12,59063,8895,0.150601899666,0.422484541877,5137,0.08697492508,3758,0.0636269745865
car,13,50303,7677,0.152615152178,0.435326299336,4335,0.0861777627577,3342,0.0664373894201
car,14,46324,7207,0.155578102064,0.428056056612,4122,0.0889819531992,3085,0.0665961488645
car,15,40099,6374,0.158956582458,0.445716975212,3533,0.088106935335,2841,0.0708496471234
car,16,36422,5765,0.158283455055,0.442671292281,3213,0.0882159134589,2552,0.0700675415957
car,17,31913,5242,0.164259079372,0.45478824876,2858,0.0895559803215,2384,0.0747030990505
car,18,29867,4889,0.163692369505,0.467580282266,2603,0.0871530451669,2286,0.0765393243379
car,19,26751,4576,0.171059025831,0.482954545455,2366,0.0884452917648,2210,0.082613734066
car,20,24626,4150,0.168521075286,0.473975903614,2183,0.0886461463494,1967,0.0798749289369
car,21,22308,3781,0.169490765645,0.482676540598,1956,0.08768154922,1825,0.0818092164246
car,22,20621,3503,0.169875369769,0.488153011704,1793,0.0869501964017,1710,0.082925173367
car,23,18281,3248,0.177670805755,0.488916256158,1660,0.0908046605766,1588,0.0868661451781
car,24,17509,3083,0.176080872694,0.511514758352,1506,0.0860129076475,1577,0.0900679650465
car,25,16036,2888,0.18009478673,0.498961218837,1447,0.090234472437,1441,0.0898603142928
car,26,14819,2541,0.171469059991,0.483667847304,1312,0.0885349888656,1229,0.0829340711249
car,27,13659,2479,0.18149205652,0.490116982654,1264,0.0925397174024,1215,0.0889523391171
car,28,13087,2269,0.173378161534,0.503746143676,1126,0.0860395812638,1143,0.0873385802705
car,29,11887,2070,0.174139816606,0.503381642512,1028,0.0864810296963,1042,0.0876587869101
car,30,11393,2108,0.185025893092,0.501423149905,1051,0.0922496269639,1057,0.0927762661283
car,31,10512,1993,0.189592846271,0.502257902659,992,0.0943683409437,1001,0.0952245053272
car,32,9552,1682,0.176088777219,0.507134363853,829,0.0867881072027,853,0.0893006700168
car,33,9111,1633,0.179233893096,0.512553582364,796,0.0873669191088,837,0.0918669739875
car,34,8963,1650,0.184090148388,0.497575757576,829,0.0924913533415,821,0.0915987950463
car,35,8115,1480,0.182378311768,0.526351351351,701,0.0863832409119,779,0.0959950708564
car,36,7564,1408,0.18614489688,0.491477272727,716,0.0946589106293,692,0.0914859862507
car,37,7212,1360,0.188574597892,0.506617647059,671,0.0930393788131,689,0.0955352190793
car,38,6807,1226,0.18010871162,0.513866231648,596,0.0875569266931,630,0.0925517849273
car,39,6350,1186,0.186771653543,0.494940978078,599,0.0943307086614,587,0.0924409448819
car,40,6072,1056,0.173913043478,0.558712121212,466,0.0767457180501,590,0.0971673254282
car,41,5863,1120,0.191028483711,0.533928571429,522,0.0890329183012,598,0.10199556541
car,42,5517,1036,0.187783215516,0.530888030888,486,0.0880913539967,550,0.0996918615189
car,43,5046,939,0.186087990488,0.506922257721,463,0.0917558462148,476,0.0943321442727
car,44,4909,896,0.182521898554,0.537946428571,414,0.0843348950906,482,0.098187003463
car,45,4684,811,0.173142613151,0.506781750925,400,0.0853970964987,411,0.0877455166524
car,46,4401,831,0.188820722563,0.53670276775,385,0.087480118155,446,0.101340604408
car,47,4142,752,0.181554804442,0.530585106383,353,0.0852245292129,399,0.0963302752294
car,48,4091,768,0.187729161574,0.5078125,378,0.0923979467123,390,0.0953312148619
car,49,3866,743,0.192188308329,0.535666218035,345,0.0892395240559,398,0.102948784273
car,50,3652,662,0.181270536692,0.518126888218,319,0.0873493975904,343,0.0939211391019
car,51,3518,666,0.189312109153,0.552552552553,298,0.0847072200114,368,0.104604889142
car,52,3408,643,0.18867370892,0.53499222395,299,0.087734741784,344,0.100938967136
car,53,3171,566,0.178492589089,0.530035335689,266,0.083885209713,300,0.0946073793756
car,54,3128,559,0.178708439898,0.518783542039,269,0.0859974424552,290,0.0927109974425
car,55,2863,528,0.184421935033,0.522727272727,252,0.0880195599022,276,0.096402375131
car,56,2869,516,0.179853607529,0.498062015504,259,0.0902753572673,257,0.0895782502614
car,57,2731,535,0.195898938118,0.536448598131,248,0.0908092273892,287,0.105089710729
car,58,2518,447,0.177521842732,0.557046979866,198,0.0786338363781,249,0.0988880063542
car,59,2517,453,0.179976162098,0.549668874172,204,0.0810488676996,249,0.0989272943981
car,60,2410,465,0.192946058091,0.552688172043,208,0.0863070539419,257,0.106639004149
car,61,2314,458,0.197925669836,0.486899563319,235,0.101555747623,223,0.0963699222126
car,62,2300,410,0.178260869565,0.548780487805,185,0.0804347826087,225,0.0978260869565
car,63,2140,380,0.177570093458,0.557894736842,168,0.0785046728972,212,0.0990654205607
car,64,2042,395,0.193437806072,0.554430379747,176,0.0861900097943,219,0.107247796278
car,65,2003,356,0.1777333999,0.553370786517,159,0.0793809286071,197,0.0983524712931
car,66,1949,354,0.181631605952,0.522598870056,169,0.0867111339148,185,0.0949204720369
car,67,1845,368,0.19945799458,0.521739130435,176,0.0953929539295,192,0.10406504065
car,68,1795,318,0.177158774373,0.581761006289,133,0.0740947075209,185,0.103064066852
car,69,1772,324,0.182844243792,0.567901234568,140,0.079006772009,184,0.103837471783
car,70,1675,331,0.197611940299,0.519637462236,159,0.0949253731343,172,0.102686567164
car,71,1611,304,0.18870266915,0.569078947368,131,0.0813159528243,173,0.107386716325
car,72,1608,294,0.182835820896,0.496598639456,148,0.092039800995,146,0.0907960199005
car,73,1471,258,0.175390890551,0.604651162791,102,0.0693405846363,156,0.106050305914
car,74,1453,262,0.180316586373,0.480916030534,136,0.093599449415,126,0.086717136958
car,75,1429,267,0.186843946816,0.554307116105,119,0.0832750174948,148,0.103568929321
car,76,1425,263,0.184561403509,0.589353612167,108,0.0757894736842,155,0.108771929825
car,77,1337,259,0.193717277487,0.548262548263,117,0.0875093492895,142,0.106207928197
car,78,1289,233,0.180760279286,0.49356223176,118,0.0915438324282,115,0.089216446858
car,79,1214,221,0.182042833608,0.524886877828,105,0.0864909390445,116,0.0955518945634
car,80,1184,231,0.195101351351,0.493506493506,117,0.0988175675676,114,0.0962837837838
car,81,1113,200,0.179694519317,0.55,90,0.0808625336927,110,0.0988319856244
car,82,1169,227,0.194183062447,0.581497797357,95,0.0812660393499,132,0.112917023097
car,83,1054,196,0.185958254269,0.571428571429,84,0.0796963946869,112,0.106261859583
car,84,1045,203,0.194258373206,0.566502463054,88,0.0842105263158,115,0.11004784689
car,85,1048,184,0.175572519084,0.516304347826,89,0.0849236641221,95,0.0906488549618
car,86,1030,194,0.188349514563,0.59793814433,78,0.0757281553398,116,0.112621359223
car,87,950,165,0.173684210526,0.521212121212,79,0.0831578947368,86,0.0905263157895
car,88,916,149,0.162663755459,0.597315436242,60,0.0655021834061,89,0.0971615720524
car,89,891,188,0.210998877666,0.531914893617,88,0.0987654320988,100,0.112233445567
car,90,882,151,0.171201814059,0.543046357616,69,0.078231292517,82,0.092970521542
car,91,845,149,0.176331360947,0.44966442953,82,0.0970414201183,67,0.0792899408284
car,92,788,132,0.167512690355,0.530303030303,62,0.0786802030457,70,0.0888324873096
car,93,761,125,0.164257555848,0.536,58,0.0762155059133,67,0.0880420499343
car,94,830,168,0.202409638554,0.583333333333,70,0.0843373493976,98,0.118072289157
car,95,734,136,0.185286103542,0.492647058824,69,0.0940054495913,67,0.091280653951
car,96,800,125,0.15625,0.504,62,0.0775,63,0.07875
car,97,676,125,0.184911242604,0.584,52,0.0769230769231,73,0.10798816568
car,98,707,122,0.172560113154,0.524590163934,58,0.0820367751061,64,0.0905233380481
car,99,662,120,0.181268882175,0.483333333333,62,0.0936555891239,58,0.0876132930514
car,100,687,150,0.218340611354,0.526666666667,71,0.103347889374,79,0.11499272198
car,101,662,125,0.188821752266,0.536,58,0.0876132930514,67,0.101208459215
car,102,655,137,0.209160305344,0.583941605839,57,0.0870229007634,80,0.12213740458
car,103,635,120,0.188976377953,0.541666666667,55,0.0866141732283,65,0.102362204724
car,104,628,108,0.171974522293,0.601851851852,43,0.0684713375796,65,0.103503184713
car,105,557,116,0.208258527828,0.48275862069,60,0.107719928187,56,0.100538599641
car,106,495,90,0.181818181818,0.511111111111,44,0.0888888888889,46,0.0929292929293
car,107,549,96,0.174863387978,0.46875,51,0.0928961748634,45,0.0819672131148
car,108,540,96,0.177777777778,0.375,60,0.111111111111,36,0.0666666666667
car,109,536,95,0.17723880597,0.578947368421,40,0.0746268656716,55,0.102611940299
car,110,469,86,0.183368869936,0.53488372093,40,0.0852878464819,46,0.0980810234542
car,111,519,89,0.171483622351,0.404494382022,53,0.102119460501,36,0.0693641618497
car,112,496,78,0.157258064516,0.551282051282,35,0.070564516129,43,0.0866935483871
car,113,487,88,0.180698151951,0.579545454545,37,0.0759753593429,51,0.104722792608
car,114,505,77,0.152475247525,0.584415584416,32,0.0633663366337,45,0.0891089108911
car,115,486,89,0.183127572016,0.516853932584,43,0.0884773662551,46,0.0946502057613
car,116,442,90,0.203619909502,0.577777777778,38,0.0859728506787,52,0.117647058824
car,117,461,89,0.19305856833,0.61797752809,34,0.0737527114967,55,0.119305856833
car,118,431,93,0.215777262181,0.548387096774,42,0.0974477958237,51,0.118329466357
car,119,458,68,0.148471615721,0.558823529412,30,0.0655021834061,38,0.0829694323144
car,120,414,62,0.149758454106,0.58064516129,26,0.0628019323671,36,0.0869565217391
car,121,426,65,0.152582159624,0.6,26,0.0610328638498,39,0.0915492957746
car,122,393,68,0.173027989822,0.5,34,0.0865139949109,34,0.0865139949109
car,123,400,60,0.15,0.433333333333,34,0.085,26,0.065
car,124,398,80,0.201005025126,0.525,38,0.0954773869347,42,0.105527638191
car,125,362,60,0.165745856354,0.55,27,0.0745856353591,33,0.0911602209945
car,126,350,60,0.171428571429,0.583333333333,25,0.0714285714286,35,0.1
car,127,356,60,0.168539325843,0.5,30,0.0842696629213,30,0.0842696629213
car,128,359,61,0.16991643454,0.524590163934,29,0.0807799442897,32,0.0891364902507
car,129,347,57,0.164265129683,0.526315789474,27,0.0778097982709,30,0.0864553314121
car,130,328,62,0.189024390244,0.5,31,0.094512195122,31,0.094512195122
car,131,306,51,0.166666666667,0.509803921569,25,0.0816993464052,26,0.0849673202614
car,132,305,50,0.16393442623,0.46,27,0.0885245901639,23,0.0754098360656
car,133,344,66,0.191860465116,0.530303030303,31,0.0901162790698,35,0.101744186047
car,134,346,66,0.190751445087,0.530303030303,31,0.0895953757225,35,0.101156069364
car,135,304,46,0.151315789474,0.608695652174,18,0.0592105263158,28,0.0921052631579
car,136,285,58,0.20350877193,0.51724137931,28,0.0982456140351,30,0.105263157895
car,137,289,55,0.190311418685,0.4,33,0.114186851211,22,0.076124567474
car,138,296,47,0.158783783784,0.63829787234,17,0.0574324324324,30,0.101351351351
car,139,283,64,0.226148409894,0.546875,29,0.102473498233,35,0.123674911661
car,140,250,54,0.216,0.592592592593,22,0.088,32,0.128
car,141,251,52,0.207171314741,0.596153846154,21,0.0836653386454,31,0.123505976096
car,142,249,50,0.200803212851,0.62,19,0.0763052208835,31,0.124497991968
car,143,279,49,0.175627240143,0.510204081633,24,0.0860215053763,25,0.089605734767
car,144,253,40,0.158102766798,0.625,15,0.0592885375494,25,0.098814229249
car,145,233,39,0.167381974249,0.410256410256,23,0.0987124463519,16,0.068669527897
car,146,225,40,0.177777777778,0.475,21,0.0933333333333,19,0.0844444444444
car,147,244,47,0.19262295082,0.553191489362,21,0.0860655737705,26,0.106557377049
car,148,214,36,0.168224299065,0.611111111111,14,0.0654205607477,22,0.102803738318
car,149,235,42,0.178723404255,0.761904761905,10,0.0425531914894,32,0.136170212766
car,150,239,47,0.196652719665,0.510638297872,23,0.0962343096234,24,0.100418410042
car,151,214,47,0.219626168224,0.595744680851,19,0.088785046729,28,0.130841121495
car,152,232,47,0.202586206897,0.425531914894,27,0.116379310345,20,0.0862068965517
car,153,192,34,0.177083333333,0.588235294118,14,0.0729166666667,20,0.104166666667
car,154,200,29,0.145,0.551724137931,13,0.065,16,0.08
car,155,190,33,0.173684210526,0.484848484848,17,0.0894736842105,16,0.0842105263158
car,156,192,29,0.151041666667,0.51724137931,14,0.0729166666667,15,0.078125
car,157,173,28,0.161849710983,0.607142857143,11,0.0635838150289,17,0.0982658959538
car,158,190,43,0.226315789474,0.53488372093,20,0.105263157895,23,0.121052631579
car,159,205,35,0.170731707317,0.571428571429,15,0.0731707317073,20,0.0975609756098
car,160,178,32,0.179775280899,0.59375,13,0.0730337078652,19,0.106741573034
car,161,167,27,0.161676646707,0.481481481481,14,0.0838323353293,13,0.0778443113772
car,162,167,32,0.191616766467,0.5,16,0.0958083832335,16,0.0958083832335
car,163,182,33,0.181318681319,0.545454545455,15,0.0824175824176,18,0.0989010989011
car,164,153,28,0.183006535948,0.5,14,0.0915032679739,14,0.0915032679739
car,165,171,27,0.157894736842,0.518518518519,13,0.0760233918129,14,0.0818713450292
car,166,165,32,0.193939393939,0.5625,14,0.0848484848485,18,0.109090909091
car,167,167,39,0.233532934132,0.435897435897,22,0.131736526946,17,0.101796407186
car,168,168,30,0.178571428571,0.4,18,0.107142857143,12,0.0714285714286
car,169,170,26,0.152941176471,0.461538461538,14,0.0823529411765,12,0.0705882352941
car,170,129,24,0.186046511628,0.5,12,0.093023255814,12,0.093023255814
car,171,163,29,0.177914110429,0.48275862069,15,0.0920245398773,14,0.0858895705521
car,172,136,21,0.154411764706,0.428571428571,12,0.0882352941176,9,0.0661764705882
car,173,143,39,0.272727272727,0.615384615385,15,0.104895104895,24,0.167832167832
car,174,157,31,0.197452229299,0.41935483871,18,0.114649681529,13,0.0828025477707
car,175,153,23,0.150326797386,0.478260869565,12,0.078431372549,11,0.0718954248366
car,176,112,25,0.223214285714,0.52,12,0.107142857143,13,0.116071428571
car,177,114,22,0.19298245614,0.590909090909,9,0.0789473684211,13,0.114035087719
car,178,127,23,0.181102362205,0.739130434783,6,0.0472440944882,17,0.133858267717
car,179,136,23,0.169117647059,0.478260869565,12,0.0882352941176,11,0.0808823529412
car,180,129,27,0.209302325581,0.444444444444,15,0.116279069767,12,0.093023255814
car,181,133,22,0.165413533835,0.5,11,0.0827067669173,11,0.0827067669173
car,182,127,20,0.157480314961,0.6,8,0.0629921259843,12,0.0944881889764
car,183,127,28,0.220472440945,0.607142857143,11,0.0866141732283,17,0.133858267717
car,184,118,28,0.237288135593,0.535714285714,13,0.110169491525,15,0.127118644068
car,185,129,28,0.217054263566,0.464285714286,15,0.116279069767,13,0.100775193798
car,186,127,26,0.204724409449,0.615384615385,10,0.0787401574803,16,0.125984251969
car,187,134,22,0.164179104478,0.590909090909,9,0.0671641791045,13,0.0970149253731
car,188,124,17,0.137096774194,0.588235294118,7,0.0564516129032,10,0.0806451612903
car,189,104,14,0.134615384615,0.5,7,0.0673076923077,7,0.0673076923077
car,190,105,18,0.171428571429,0.666666666667,6,0.0571428571429,12,0.114285714286
car,191,110,21,0.190909090909,0.52380952381,10,0.0909090909091,11,0.1
car,192,101,17,0.168316831683,0.470588235294,9,0.0891089108911,8,0.0792079207921
car,193,106,18,0.169811320755,0.611111111111,7,0.0660377358491,11,0.103773584906
car,194,127,15,0.11811023622,0.6,6,0.0472440944882,9,0.0708661417323
car,195,124,9,0.0725806451613,0.555555555556,4,0.0322580645161,5,0.0403225806452
car,196,103,20,0.194174757282,0.2,16,0.155339805825,4,0.0388349514563
car,197,107,20,0.18691588785,0.5,10,0.0934579439252,10,0.0934579439252
car,198,98,12,0.122448979592,0.583333333333,5,0.0510204081633,7,0.0714285714286
car,199,86,21,0.244186046512,0.380952380952,13,0.151162790698,8,0.093023255814
car,200,111,24,0.216216216216,0.541666666667,11,0.0990990990991,13,0.117117117117
car,201,100,20,0.2,0.45,11,0.11,9,0.09
car,202,100,8,0.08,0.625,3,0.03,5,0.05
car,203,102,23,0.225490196078,0.565217391304,10,0.0980392156863,13,0.127450980392
car,204,82,21,0.256097560976,0.333333333333,14,0.170731707317,7,0.0853658536585
car,205,84,15,0.178571428571,0.4,9,0.107142857143,6,0.0714285714286
car,206,84,17,0.202380952381,0.529411764706,8,0.0952380952381,9,0.107142857143
car,207,93,13,0.139784946237,0.538461538462,6,0.0645161290323,7,0.0752688172043
car,208,91,25,0.274725274725,0.68,8,0.0879120879121,17,0.186813186813
car,209,96,13,0.135416666667,0.615384615385,5,0.0520833333333,8,0.0833333333333
car,210,89,16,0.179775280899,0.625,6,0.0674157303371,10,0.112359550562
car,211,102,20,0.196078431373,0.6,8,0.078431372549,12,0.117647058824
car,212,87,17,0.195402298851,0.529411764706,8,0.0919540229885,9,0.103448275862
car,213,99,16,0.161616161616,0.5625,7,0.0707070707071,9,0.0909090909091
car,214,80,17,0.2125,0.647058823529,6,0.075,11,0.1375
car,215,110,19,0.172727272727,0.526315789474,9,0.0818181818182,10,0.0909090909091
car,216,74,11,0.148648648649,0.363636363636,7,0.0945945945946,4,0.0540540540541
car,217,83,9,0.10843373494,0.555555555556,4,0.0481927710843,5,0.0602409638554
car,218,71,10,0.140845070423,0.7,3,0.0422535211268,7,0.0985915492958
car,219,70,13,0.185714285714,0.769230769231,3,0.0428571428571,10,0.142857142857
car,220,66,14,0.212121212121,0.428571428571,8,0.121212121212,6,0.0909090909091
car,221,80,12,0.15,0.583333333333,5,0.0625,7,0.0875
car,222,69,16,0.231884057971,0.6875,5,0.0724637681159,11,0.159420289855
car,223,69,13,0.188405797101,0.461538461538,7,0.101449275362,6,0.0869565217391
car,224,66,13,0.19696969697,0.692307692308,4,0.0606060606061,9,0.136363636364
car,225,69,13,0.188405797101,0.692307692308,4,0.0579710144928,9,0.130434782609
car,226,70,14,0.2,0.642857142857,5,0.0714285714286,9,0.128571428571
car,227,67,10,0.149253731343,0.8,2,0.0298507462687,8,0.119402985075
car,228,68,14,0.205882352941,0.642857142857,5,0.0735294117647,9,0.132352941176
car,229,65,18,0.276923076923,0.555555555556,8,0.123076923077,10,0.153846153846
car,230,66,7,0.106060606061,0.714285714286,2,0.030303030303,5,0.0757575757576
car,231,68,9,0.132352941176,0.555555555556,4,0.0588235294118,5,0.0735294117647
car,232,53,6,0.11320754717,0.5,3,0.0566037735849,3,0.0566037735849
car,233,65,13,0.2,0.538461538462,6,0.0923076923077,7,0.107692307692
car,234,67,11,0.164179104478,0.454545454545,6,0.089552238806,5,0.0746268656716
car,235,66,9,0.136363636364,0.444444444444,5,0.0757575757576,4,0.0606060606061
car,236,55,17,0.309090909091,0.352941176471,11,0.2,6,0.109090909091
car,237,58,10,0.172413793103,0.5,5,0.0862068965517,5,0.0862068965517
car,238,57,9,0.157894736842,0.666666666667,3,0.0526315789474,6,0.105263157895
car,239,46,9,0.195652173913,0.444444444444,5,0.108695652174,4,0.0869565217391
car,240,58,10,0.172413793103,0.5,5,0.0862068965517,5,0.0862068965517
car,241,66,12,0.181818181818,0.25,9,0.136363636364,3,0.0454545454545
car,242,49,7,0.142857142857,0.571428571429,3,0.0612244897959,4,0.0816326530612
car,243,74,10,0.135135135135,0.6,4,0.0540540540541,6,0.0810810810811
car,244,66,9,0.136363636364,0.666666666667,3,0.0454545454545,6,0.0909090909091
car,245,53,15,0.283018867925,0.466666666667,8,0.150943396226,7,0.132075471698
car,246,63,14,0.222222222222,0.357142857143,9,0.142857142857,5,0.0793650793651
car,247,47,11,0.234042553191,0.454545454545,6,0.127659574468,5,0.106382978723
car,248,66,15,0.227272727273,0.533333333333,7,0.106060606061,8,0.121212121212
car,249,47,7,0.148936170213,0.571428571429,3,0.063829787234,4,0.0851063829787
car,250,55,15,0.272727272727,0.6,6,0.109090909091,9,0.163636363636
car,251,44,7,0.159090909091,0.571428571429,3,0.0681818181818,4,0.0909090909091
car,252,43,6,0.139534883721,0.333333333333,4,0.093023255814,2,0.046511627907
car,253,45,8,0.177777777778,0.625,3,0.0666666666667,5,0.111111111111
car,254,44,5,0.113636363636,0.6,2,0.0454545454545,3,0.0681818181818
car,255,50,6,0.12,0.333333333333,4,0.08,2,0.04
car,256,50,9,0.18,0.555555555556,4,0.08,5,0.1
car,257,44,8,0.181818181818,0.75,2,0.0454545454545,6,0.136363636364
car,258,39,8,0.205128205128,0.375,5,0.128205128205,3,0.0769230769231
car,259,47,6,0.127659574468,0.333333333333,4,0.0851063829787,2,0.0425531914894
car,260,42,11,0.261904761905,0.454545454545,6,0.142857142857,5,0.119047619048
car,261,51,8,0.156862745098,0.5,4,0.078431372549,4,0.078431372549
car,262,44,10,0.227272727273,0.6,4,0.0909090909091,6,0.136363636364
car,263,58,10,0.172413793103,0.7,3,0.051724137931,7,0.120689655172
car,264,34,4,0.117647058824,0.75,1,0.0294117647059,3,0.0882352941176
car,265,37,7,0.189189189189,0.571428571429,3,0.0810810810811,4,0.108108108108
car,266,51,9,0.176470588235,0.666666666667,3,0.0588235294118,6,0.117647058824
car,267,38,7,0.184210526316,0.571428571429,3,0.0789473684211,4,0.105263157895
car,268,33,6,0.181818181818,0.333333333333,4,0.121212121212,2,0.0606060606061
car,269,37,8,0.216216216216,0.625,3,0.0810810810811,5,0.135135135135
car,270,49,5,0.102040816327,0.6,2,0.0408163265306,3,0.0612244897959
car,271,40,10,0.25,0.7,3,0.075,7,0.175
car,272,41,6,0.146341463415,0.666666666667,2,0.0487804878049,4,0.0975609756098
car,273,44,9,0.204545454545,0.666666666667,3,0.0681818181818,6,0.136363636364
car,274,35,7,0.2,0.571428571429,3,0.0857142857143,4,0.114285714286
car,275,35,3,0.0857142857143,0.333333333333,2,0.0571428571429,1,0.0285714285714
car,276,35,8,0.228571428571,0.625,3,0.0857142857143,5,0.142857142857
car,277,28,4,0.142857142857,0.75,1,0.0357142857143,3,0.107142857143
car,278,32,6,0.1875,0.666666666667,2,0.0625,4,0.125
car,279,39,7,0.179487179487,0.428571428571,4,0.102564102564,3,0.0769230769231
car,280,39,4,0.102564102564,0.5,2,0.0512820512821,2,0.0512820512821
car,281,51,13,0.254901960784,0.461538461538,7,0.137254901961,6,0.117647058824
car,282,40,6,0.15,0.333333333333,4,0.1,2,0.05
car,283,38,4,0.105263157895,0.75,1,0.0263157894737,3,0.0789473684211
car,284,38,10,0.263157894737,0.4,6,0.157894736842,4,0.105263157895
car,285,38,7,0.184210526316,0.857142857143,1,0.0263157894737,6,0.157894736842
car,286,31,6,0.193548387097,1.0,0,0.0,6,0.193548387097
car,287,33,4,0.121212121212,0.5,2,0.0606060606061,2,0.0606060606061
car,288,33,6,0.181818181818,0.666666666667,2,0.0606060606061,4,0.121212121212
car,289,26,4,0.153846153846,0.25,3,0.115384615385,1,0.0384615384615
car,290,40,5,0.125,0.6,2,0.05,3,0.075
car,291,27,5,0.185185185185,0.4,3,0.111111111111,2,0.0740740740741
car,292,42,5,0.119047619048,0.2,4,0.0952380952381,1,0.0238095238095
car,293,23,5,0.217391304348,0.6,2,0.0869565217391,3,0.130434782609
car,294,32,13,0.40625,0.384615384615,8,0.25,5,0.15625
car,295,34,2,0.0588235294118,0.0,2,0.0588235294118,0,0.0
car,296,32,8,0.25,0.375,5,0.15625,3,0.09375
car,297,23,2,0.0869565217391,0.5,1,0.0434782608696,1,0.0434782608696
car,298,24,5,0.208333333333,0.2,4,0.166666666667,1,0.0416666666667
car,299,30,5,0.166666666667,0.6,2,0.0666666666667,3,0.1
car,300,30,2,0.0666666666667,1.0,0,0.0,2,0.0666666666667
car,301,39,5,0.128205128205,0.4,3,0.0769230769231,2,0.0512820512821
car,302,29,4,0.137931034483,0.75,1,0.0344827586207,3,0.103448275862
car,303,32,2,0.0625,0.5,1,0.03125,1,0.03125
car,304,29,3,0.103448275862,1.0,0,0.0,3,0.103448275862
car,305,29,7,0.241379310345,0.571428571429,3,0.103448275862,4,0.137931034483
car,306,29,6,0.206896551724,0.333333333333,4,0.137931034483,2,0.0689655172414
car,307,35,5,0.142857142857,0.2,4,0.114285714286,1,0.0285714285714
car,308,31,7,0.225806451613,0.428571428571,4,0.129032258065,3,0.0967741935484
car,309,33,4,0.121212121212,0.25,3,0.0909090909091,1,0.030303030303
car,310,22,4,0.181818181818,0.5,2,0.0909090909091,2,0.0909090909091
car,311,22,2,0.0909090909091,1.0,0,0.0,2,0.0909090909091
car,312,20,5,0.25,0.2,4,0.2,1,0.05
car,313,21,6,0.285714285714,0.333333333333,4,0.190476190476,2,0.0952380952381
car,314,25,3,0.12,0.666666666667,1,0.04,2,0.08
car,315,33,7,0.212121212121,0.571428571429,3,0.0909090909091,4,0.121212121212
car,316,27,4,0.148148148148,0.75,1,0.037037037037,3,0.111111111111
car,317,21,4,0.190476190476,0.25,3,0.142857142857,1,0.047619047619
car,318,22,3,0.136363636364,1.0,0,0.0,3,0.136363636364
car,319,24,4,0.166666666667,1.0,0,0.0,4,0.166666666667
car,320,37,9,0.243243243243,0.555555555556,4,0.108108108108,5,0.135135135135
car,321,20,2,0.1,0.0,2,0.1,0,0.0
car,322,16,3,0.1875,1.0,0,0.0,3,0.1875
car,323,14,4,0.285714285714,0.75,1,0.0714285714286,3,0.214285714286
car,324,22,3,0.136363636364,0.333333333333,2,0.0909090909091,1,0.0454545454545
car,325,25,5,0.2,0.6,2,0.08,3,0.12
car,326,24,5,0.208333333333,0.2,4,0.166666666667,1,0.0416666666667
car,327,15,2,0.133333333333,0.5,1,0.0666666666667,1,0.0666666666667
car,328,24,3,0.125,1.0,0,0.0,3,0.125
car,329,21,6,0.285714285714,0.5,3,0.142857142857,3,0.142857142857
car,330,12,2,0.166666666667,1.0,0,0.0,2,0.166666666667
car,331,22,6,0.272727272727,0.833333333333,1,0.0454545454545,5,0.227272727273
car,332,26,5,0.192307692308,0.4,3,0.115384615385,2,0.0769230769231
car,333,29,5,0.172413793103,0.2,4,0.137931034483,1,0.0344827586207
car,334,27,5,0.185185185185,0.2,4,0.148148148148,1,0.037037037037
car,335,20,7,0.35,0.142857142857,6,0.3,1,0.05
car,336,21,2,0.0952380952381,0.5,1,0.047619047619,1,0.047619047619
car,337,22,2,0.0909090909091,0.0,2,0.0909090909091,0,0.0
car,338,21,6,0.285714285714,0.5,3,0.142857142857,3,0.142857142857
car,339,13,4,0.307692307692,0.25,3,0.230769230769,1,0.0769230769231
car,340,22,3,0.136363636364,0.666666666667,1,0.0454545454545,2,0.0909090909091
car,341,10,1,0.1,1.0,0,0.0,1,0.1
car,342,23,5,0.217391304348,0.4,3,0.130434782609,2,0.0869565217391
car,343,21,3,0.142857142857,0.0,3,0.142857142857,0,0.0
car,344,18,3,0.166666666667,0.666666666667,1,0.0555555555556,2,0.111111111111
car,345,21,4,0.190476190476,0.75,1,0.047619047619,3,0.142857142857
car,346,26,3,0.115384615385,0.333333333333,2,0.0769230769231,1,0.0384615384615
car,347,25,3,0.12,0.666666666667,1,0.04,2,0.08
car,348,13,3,0.230769230769,1.0,0,0.0,3,0.230769230769
car,349,23,3,0.130434782609,0.666666666667,1,0.0434782608696,2,0.0869565217391
car,350,17,3,0.176470588235,0.333333333333,2,0.117647058824,1,0.0588235294118
car,351,15,1,0.0666666666667,1.0,0,0.0,1,0.0666666666667
car,352,15,2,0.133333333333,0.5,1,0.0666666666667,1,0.0666666666667
car,353,19,1,0.0526315789474,0.0,1,0.0526315789474,0,0.0
car,354,21,1,0.047619047619,0.0,1,0.047619047619,0,0.0
car,355,17,5,0.294117647059,0.8,1,0.0588235294118,4,0.235294117647
car,356,17,6,0.352941176471,0.666666666667,2,0.117647058824,4,0.235294117647
car,357,21,3,0.142857142857,0.0,3,0.142857142857,0,0.0
car,358,22,2,0.0909090909091,0.5,1,0.0454545454545,1,0.0454545454545
car,359,17,4,0.235294117647,0.0,4,0.235294117647,0,0.0
car,360,21,3,0.142857142857,0.333333333333,2,0.0952380952381,1,0.047619047619
car,361,13,1,0.0769230769231,1.0,0,0.0,1,0.0769230769231
car,362,18,2,0.111111111111,0.0,2,0.111111111111,0,0.0
car,363,16,6,0.375,0.666666666667,2,0.125,4,0.25
car,364,16,2,0.125,0.5,1,0.0625,1,0.0625
car,365,18,2,0.111111111111,0.5,1,0.0555555555556,1,0.0555555555556
car,366,14,1,0.0714285714286,0.0,1,0.0714285714286,0,0.0
car,367,16,2,0.125,0.5,1,0.0625,1,0.0625
car,368,12,2,0.166666666667,1.0,0,0.0,2,0.166666666667
car,369,20,4,0.2,0.25,3,0.15,1,0.05
car,370,10,1,0.1,1.0,0,0.0,1,0.1
car,371,20,1,0.05,0.0,1,0.05,0,0.0
car,372,25,4,0.16,0.5,2,0.08,2,0.08
car,373,21,1,0.047619047619,1.0,0,0.0,1,0.047619047619
car,374,22,5,0.227272727273,0.2,4,0.181818181818,1,0.0454545454545
car,375,12,3,0.25,0.666666666667,1,0.0833333333333,2,0.166666666667
car,376,16,4,0.25,0.75,1,0.0625,3,0.1875
car,377,17,4,0.235294117647,0.5,2,0.117647058824,2,0.117647058824
car,378,24,5,0.208333333333,0.2,4,0.166666666667,1,0.0416666666667
car,379,10,1,0.1,1.0,0,0.0,1,0.1
car,380,19,4,0.210526315789,0.25,3,0.157894736842,1,0.0526315789474
car,381,16,1,0.0625,1.0,0,0.0,1,0.0625
car,382,13,3,0.230769230769,0.666666666667,1,0.0769230769231,2,0.153846153846
car,383,14,3,0.214285714286,0.333333333333,2,0.142857142857,1,0.0714285714286
car,384,13,1,0.0769230769231,0.0,1,0.0769230769231,0,0.0
car,385,19,4,0.210526315789,0.5,2,0.105263157895,2,0.105263157895
car,386,21,3,0.142857142857,1.0,0,0.0,3,0.142857142857
car,387,14,1,0.0714285714286,1.0,0,0.0,1,0.0714285714286
car,388,13,2,0.153846153846,0.0,2,0.153846153846,0,0.0
car,389,13,5,0.384615384615,0.0,5,0.384615384615,0,0.0
car,390,13,2,0.153846153846,0.5,1,0.0769230769231,1,0.0769230769231
car,391,12,0,0.0,NULL,0,0.0,0,0.0
car,392,14,1,0.0714285714286,0.0,1,0.0714285714286,0,0.0
car,393,10,1,0.1,0.0,1,0.1,0,0.0
car,394,17,4,0.235294117647,0.25,3,0.176470588235,1,0.0588235294118
car,395,15,1,0.0666666666667,0.0,1,0.0666666666667,0,0.0
car,396,13,1,0.0769230769231,0.0,1,0.0769230769231,0,0.0
car,397,14,1,0.0714285714286,1.0,0,0.0,1,0.0714285714286
car,398,8,2,0.25,1.0,0,0.0,2,0.25
car,399,12,0,0.0,NULL,0,0.0,0,0.0
car,400,18,3,0.166666666667,0.666666666667,1,0.0555555555556,2,0.111111111111
car,401,13,1,0.0769230769231,1.0,0,0.0,1,0.0769230769231
car,402,13,1,0.0769230769231,1.0,0,0.0,1,0.0769230769231
car,403,16,4,0.25,0.5,2,0.125,2,0.125
car,404,14,3,0.214285714286,0.333333333333,2,0.142857142857,1,0.0714285714286
car,405,8,1,0.125,0.0,1,0.125,0,0.0
car,406,11,3,0.272727272727,0.333333333333,2,0.181818181818,1,0.0909090909091
car,407,9,1,0.111111111111,1.0,0,0.0,1,0.111111111111
car,408,10,1,0.1,1.0,0,0.0,1,0.1
car,409,14,5,0.357142857143,0.2,4,0.285714285714,1,0.0714285714286
car,410,15,2,0.133333333333,0.5,1,0.0666666666667,1,0.0666666666667
car,411,13,2,0.153846153846,1.0,0,0.0,2,0.153846153846
car,412,13,2,0.153846153846,0.5,1,0.0769230769231,1,0.0769230769231
car,413,9,1,0.111111111111,1.0,0,0.0,1,0.111111111111
car,414,15,2,0.133333333333,1.0,0,0.0,2,0.133333333333
car,415,9,2,0.222222222222,0.5,1,0.111111111111,1,0.111111111111
car,416,15,6,0.4,0.666666666667,2,0.133333333333,4,0.266666666667
car,417,14,3,0.214285714286,1.0,0,0.0,3,0.214285714286
car,418,10,5,0.5,0.2,4,0.4,1,0.1
car,419,8,4,0.5,0.25,3,0.375,1,0.125
car,420,15,2,0.133333333333,0.5,1,0.0666666666667,1,0.0666666666667
car,421,5,0,0.0,NULL,0,0.0,0,0.0
car,422,12,3,0.25,0.666666666667,1,0.0833333333333,2,0.166666666667
car,423,8,1,0.125,1.0,0,0.0,1,0.125
car,424,14,3,0.214285714286,0.666666666667,1,0.0714285714286,2,0.142857142857
car,425,8,1,0.125,1.0,0,0.0,1,0.125
car,426,11,5,0.454545454545,0.2,4,0.363636363636,1,0.0909090909091
car,427,15,1,0.0666666666667,0.0,1,0.0666666666667,0,0.0
car,428,9,3,0.333333333333,0.0,3,0.333333333333,0,0.0
car,429,3,0,0.0,NULL,0,0.0,0,0.0
car,430,8,1,0.125,1.0,0,0.0,1,0.125
car,431,12,1,0.0833333333333,0.0,1,0.0833333333333,0,0.0
car,432,7,1,0.142857142857,1.0,0,0.0,1,0.142857142857
car,433,14,1,0.0714285714286,0.0,1,0.0714285714286,0,0.0
car,434,16,2,0.125,1.0,0,0.0,2,0.125
car,435,10,0,0.0,NULL,0,0.0,0,0.0
car,436,9,1,0.111111111111,1.0,0,0.0,1,0.111111111111
car,437,7,1,0.142857142857,0.0,1,0.142857142857,0,0.0
car,438,9,2,0.222222222222,0.5,1,0.111111111111,1,0.111111111111
car,439,6,2,0.333333333333,0.5,1,0.166666666667,1,0.166666666667
car,440,10,1,0.1,1.0,0,0.0,1,0.1
car,441,11,1,0.0909090909091,1.0,0,0.0,1,0.0909090909091
car,442,6,1,0.166666666667,1.0,0,0.0,1,0.166666666667
car,443,14,3,0.214285714286,0.333333333333,2,0.142857142857,1,0.0714285714286
car,444,8,2,0.25,0.5,1,0.125,1,0.125
car,445,10,1,0.1,0.0,1,0.1,0,0.0
car,446,11,2,0.181818181818,0.5,1,0.0909090909091,1,0.0909090909091
car,447,5,2,0.4,0.5,1,0.2,1,0.2
car,448,4,2,0.5,1.0,0,0.0,2,0.5
car,449,10,1,0.1,0.0,1,0.1,0,0.0
car,450,3,1,0.333333333333,1.0,0,0.0,1,0.333333333333
car,451,7,1,0.142857142857,1.0,0,0.0,1,0.142857142857
car,452,9,0,0.0,NULL,0,0.0,0,0.0
car,453,10,1,0.1,1.0,0,0.0,1,0.1
car,454,9,0,0.0,NULL,0,0.0,0,0.0
car,455,9,1,0.111111111111,1.0,0,0.0,1,0.111111111111
car,456,11,1,0.0909090909091,1.0,0,0.0,1,0.0909090909091
car,457,6,1,0.166666666667,1.0,0,0.0,1,0.166666666667
car,458,12,3,0.25,0.333333333333,2,0.166666666667,1,0.0833333333333
car,459,10,1,0.1,0.0,1,0.1,0,0.0
car,460,10,1,0.1,0.0,1,0.1,0,0.0
car,461,14,3,0.214285714286,0.333333333333,2,0.142857142857,1,0.0714285714286
car,462,11,1,0.0909090909091,1.0,0,0.0,1,0.0909090909091
car,463,5,2,0.4,0.5,1,0.2,1,0.2
car,464,8,0,0.0,NULL,0,0.0,0,0.0
car,465,8,2,0.25,0.5,1,0.125,1,0.125
car,466,9,0,0.0,NULL,0,0.0,0,0.0
car,467,9,2,0.222222222222,0.5,1,0.111111111111,1,0.111111111111
car,468,6,1,0.166666666667,1.0,0,0.0,1,0.166666666667
car,469,4,2,0.5,1.0,0,0.0,2,0.5
car,470,9,1,0.111111111111,1.0,0,0.0,1,0.111111111111
car,471,6,1,0.166666666667,1.0,0,0.0,1,0.166666666667
car,472,7,0,0.0,NULL,0,0.0,0,0.0
car,473,8,2,0.25,0.0,2,0.25,0,0.0
car,474,8,1,0.125,1.0,0,0.0,1,0.125
car,475,3,1,0.333333333333,0.0,1,0.333333333333,0,0.0
car,476,9,1,0.111111111111,1.0,0,0.0,1,0.111111111111
car,477,6,2,0.333333333333,0.5,1,0.166666666667,1,0.166666666667
car,478,4,1,0.25,1.0,0,0.0,1,0.25
car,479,6,1,0.166666666667,0.0,1,0.166666666667,0,0.0
car,480,8,0,0.0,NULL,0,0.0,0,0.0
car,481,7,0,0.0,NULL,0,0.0,0,0.0
car,482,11,1,0.0909090909091,1.0,0,0.0,1,0.0909090909091
car,483,5,1,0.2,0.0,1,0.2,0,0.0
car,484,3,0,0.0,NULL,0,0.0,0,0.0
car,485,5,0,0.0,NULL,0,0.0,0,0.0
car,486,11,0,0.0,NULL,0,0.0,0,0.0
car,487,3,1,0.333333333333,1.0,0,0.0,1,0.333333333333
car,488,7,4,0.571428571429,0.75,1,0.142857142857,3,0.428571428571
car,489,12,1,0.0833333333333,0.0,1,0.0833333333333,0,0.0
car,490,7,2,0.285714285714,1.0,0,0.0,2,0.285714285714
car,491,5,1,0.2,1.0,0,0.0,1,0.2
car,492,9,1,0.111111111111,0.0,1,0.111111111111,0,0.0
car,493,8,1,0.125,0.0,1,0.125,0,0.0
car,494,5,1,0.2,1.0,0,0.0,1,0.2
car,495,3,0,0.0,NULL,0,0.0,0,0.0
car,496,7,1,0.142857142857,0.0,1,0.142857142857,0,0.0
car,497,6,3,0.5,0.333333333333,2,0.333333333333,1,0.166666666667
car,498,5,0,0.0,NULL,0,0.0,0,0.0
car,499,7,1,0.142857142857,1.0,0,0.0,1,0.142857142857
car,500,6,1,0.166666666667,0.0,1,0.166666666667,0,0.0
car,501,3,0,0.0,NULL,0,0.0,0,0.0
car,502,12,1,0.0833333333333,1.0,0,0.0,1,0.0833333333333
car,503,8,2,0.25,0.5,1,0.125,1,0.125
car,504,7,3,0.428571428571,0.0,3,0.428571428571,0,0.0
car,505,7,1,0.142857142857,0.0,1,0.142857142857,0,0.0
car,506,8,0,0.0,NULL,0,0.0,0,0.0
car,507,8,2,0.25,1.0,0,0.0,2,0.25
car,508,7,0,0.0,NULL,0,0.0,0,0.0
car,509,2,0,0.0,NULL,0,0.0,0,0.0
car,510,3,0,0.0,NULL,0,0.0,0,0.0
car,511,2,0,0.0,NULL,0,0.0,0,0.0
car,512,5,0,0.0,NULL,0,0.0,0,0.0
car,513,9,3,0.333333333333,1.0,0,0.0,3,0.333333333333
car,514,6,0,0.0,NULL,0,0.0,0,0.0
car,515,8,1,0.125,0.0,1,0.125,0,0.0
car,516,4,1,0.25,1.0,0,0.0,1,0.25
car,517,5,3,0.6,0.666666666667,1,0.2,2,0.4
car,518,4,1,0.25,1.0,0,0.0,1,0.25
car,519,2,0,0.0,NULL,0,0.0,0,0.0
car,520,6,0,0.0,NULL,0,0.0,0,0.0
car,521,2,1,0.5,0.0,1,0.5,0,0.0
car,522,5,0,0.0,NULL,0,0.0,0,0.0
car,523,11,2,0.181818181818,1.0,0,0.0,2,0.181818181818
car,524,2,0,0.0,NULL,0,0.0,0,0.0
car,525,10,1,0.1,1.0,0,0.0,1,0.1
car,526,6,1,0.166666666667,1.0,0,0.0,1,0.166666666667
car,527,2,0,0.0,NULL,0,0.0,0,0.0
car,528,10,1,0.1,0.0,1,0.1,0,0.0
car,529,7,1,0.142857142857,1.0,0,0.0,1,0.142857142857
car,530,8,1,0.125,1.0,0,0.0,1,0.125
car,531,4,0,0.0,NULL,0,0.0,0,0.0
car,532,4,1,0.25,0.0,1,0.25,0,0.0
car,533,5,0,0.0,NULL,0,0.0,0,0.0
car,534,9,1,0.111111111111,0.0,1,0.111111111111,0,0.0
car,535,2,0,0.0,NULL,0,0.0,0,0.0
car,536,5,2,0.4,0.5,1,0.2,1,0.2
car,537,6,2,0.333333333333,0.5,1,0.166666666667,1,0.166666666667
car,538,6,1,0.166666666667,0.0,1,0.166666666667,0,0.0
car,539,4,0,0.0,NULL,0,0.0,0,0.0
car,540,7,1,0.142857142857,1.0,0,0.0,1,0.142857142857
car,541,8,1,0.125,1.0,0,0.0,1,0.125
car,542,7,3,0.428571428571,0.333333333333,2,0.285714285714,1,0.142857142857
car,543,3,1,0.333333333333,1.0,0,0.0,1,0.333333333333
car,544,4,0,0.0,NULL,0,0.0,0,0.0
car,545,3,0,0.0,NULL,0,0.0,0,0.0
car,546,6,1,0.166666666667,0.0,1,0.166666666667,0,0.0
car,547,3,0,0.0,NULL,0,0.0,0,0.0
car,548,6,2,0.333333333333,0.5,1,0.166666666667,1,0.166666666667
car,549,5,3,0.6,0.333333333333,2,0.4,1,0.2
car,550,10,2,0.2,1.0,0,0.0,2,0.2
car,551,2,0,0.0,NULL,0,0.0,0,0.0
car,552,5,3,0.6,0.0,3,0.6,0,0.0
car,553,3,0,0.0,NULL,0,0.0,0,0.0
car,554,5,0,0.0,NULL,0,0.0,0,0.0
car,555,5,0,0.0,NULL,0,0.0,0,0.0
car,556,4,1,0.25,1.0,0,0.0,1,0.25
car,557,4,0,0.0,NULL,0,0.0,0,0.0
car,558,6,3,0.5,0.666666666667,1,0.166666666667,2,0.333333333333
car,559,2,0,0.0,NULL,0,0.0,0,0.0
car,560,6,1,0.166666666667,1.0,0,0.0,1,0.166666666667
car,561,6,3,0.5,1.0,0,0.0,3,0.5
car,562,3,0,0.0,NULL,0,0.0,0,0.0
car,563,3,1,0.333333333333,1.0,0,0.0,1,0.333333333333
car,564,5,0,0.0,NULL,0,0.0,0,0.0
car,565,3,1,0.333333333333,1.0,0,0.0,1,0.333333333333
car,566,4,1,0.25,0.0,1,0.25,0,0.0
car,567,4,0,0.0,NULL,0,0.0,0,0.0
car,568,7,1,0.142857142857,1.0,0,0.0,1,0.142857142857
car,569,4,0,0.0,NULL,0,0.0,0,0.0
car,570,1,0,0.0,NULL,0,0.0,0,0.0
car,571,2,0,0.0,NULL,0,0.0,0,0.0
car,572,3,1,0.333333333333,1.0,0,0.0,1,0.333333333333
car,573,1,0,0.0,NULL,0,0.0,0,0.0
car,574,5,1,0.2,0.0,1,0.2,0,0.0
car,575,1,1,1.0,1.0,0,0.0,1,1.0
car,576,2,0,0.0,NULL,0,0.0,0,0.0
car,577,1,1,1.0,0.0,1,1.0,0,0.0
car,578,4,3,0.75,0.333333333333,2,0.5,1,0.25
car,579,2,0,0.0,NULL,0,0.0,0,0.0
car,580,5,1,0.2,0.0,1,0.2,0,0.0
car,581,2,0,0.0,NULL,0,0.0,0,0.0
car,582,6,0,0.0,NULL,0,0.0,0,0.0
car,583,7,2,0.285714285714,0.0,2,0.285714285714,0,0.0
car,584,5,1,0.2,1.0,0,0.0,1,0.2
car,585,4,2,0.5,0.5,1,0.25,1,0.25
car,586,7,0,0.0,NULL,0,0.0,0,0.0
car,587,4,1,0.25,0.0,1,0.25,0,0.0
car,588,5,0,0.0,NULL,0,0.0,0,0.0
car,589,6,3,0.5,0.0,3,0.5,0,0.0
car,590,4,0,0.0,NULL,0,0.0,0,0.0
car,591,3,2,0.666666666667,0.0,2,0.666666666667,0,0.0
car,592,3,1,0.333333333333,0.0,1,0.333333333333,0,0.0
car,593,2,0,0.0,NULL,0,0.0,0,0.0
car,594,3,0,0.0,NULL,0,0.0,0,0.0
car,595,5,0,0.0,NULL,0,0.0,0,0.0
car,596,7,1,0.142857142857,0.0,1,0.142857142857,0,0.0
car,597,4,0,0.0,NULL,0,0.0,0,0.0
car,598,2,0,0.0,NULL,0,0.0,0,0.0
car,599,3,2,0.666666666667,1.0,0,0.0,2,0.666666666667
car,600,3,0,0.0,NULL,0,0.0,0,0.0
car,601,2,1,0.5,0.0,1,0.5,0,0.0
car,602,1,0,0.0,NULL,0,0.0,0,0.0
car,603,3,0,0.0,NULL,0,0.0,0,0.0
car,604,2,1,0.5,0.0,1,0.5,0,0.0
car,606,6,2,0.333333333333,1.0,0,0.0,2,0.333333333333
car,607,4,1,0.25,0.0,1,0.25,0,0.0
car,609,3,0,0.0,NULL,0,0.0,0,0.0
car,610,1,1,1.0,0.0,1,1.0,0,0.0
car,611,2,1,0.5,1.0,0,0.0,1,0.5
car,612,3,1,0.333333333333,1.0,0,0.0,1,0.333333333333
car,613,2,1,0.5,1.0,0,0.0,1,0.5
car,615,3,0,0.0,NULL,0,0.0,0,0.0
car,616,1,0,0.0,NULL,0,0.0,0,0.0
car,618,3,0,0.0,NULL,0,0.0,0,0.0
car,619,4,1,0.25,1.0,0,0.0,1,0.25
car,620,4,0,0.0,NULL,0,0.0,0,0.0
car,621,3,0,0.0,NULL,0,0.0,0,0.0
car,623,2,0,0.0,NULL,0,0.0,0,0.0
car,624,4,2,0.5,0.5,1,0.25,1,0.25
car,625,3,0,0.0,NULL,0,0.0,0,0.0
car,626,3,2,0.666666666667,0.5,1,0.333333333333,1,0.333333333333
car,627,6,0,0.0,NULL,0,0.0,0,0.0
car,628,6,1,0.166666666667,0.0,1,0.166666666667,0,0.0
car,629,2,0,0.0,NULL,0,0.0,0,0.0
car,630,3,0,0.0,NULL,0,0.0,0,0.0
car,631,4,3,0.75,1.0,0,0.0,3,0.75
car,632,1,0,0.0,NULL,0,0.0,0,0.0
car,633,4,0,0.0,NULL,0,0.0,0,0.0
car,634,7,2,0.285714285714,0.5,1,0.142857142857,1,0.142857142857
car,635,3,1,0.333333333333,1.0,0,0.0,1,0.333333333333
car,636,3,0,0.0,NULL,0,0.0,0,0.0
car,637,6,2,0.333333333333,0.0,2,0.333333333333,0,0.0
car,638,4,3,0.75,0.333333333333,2,0.5,1,0.25
car,639,4,0,0.0,NULL,0,0.0,0,0.0
car,640,3,1,0.333333333333,1.0,0,0.0,1,0.333333333333
car,641,1,0,0.0,NULL,0,0.0,0,0.0
car,642,3,0,0.0,NULL,0,0.0,0,0.0
car,643,4,0,0.0,NULL,0,0.0,0,0.0
car,644,4,0,0.0,NULL,0,0.0,0,0.0
car,645,2,0,0.0,NULL,0,0.0,0,0.0
car,646,1,0,0.0,NULL,0,0.0,0,0.0
car,647,4,0,0.0,NULL,0,0.0,0,0.0
car,648,2,2,1.0,1.0,0,0.0,2,1.0
car,649,2,1,0.5,0.0,1,0.5,0,0.0
car,650,1,0,0.0,NULL,0,0.0,0,0.0
car,651,4,0,0.0,NULL,0,0.0,0,0.0
car,652,5,1,0.2,1.0,0,0.0,1,0.2
car,653,2,1,0.5,1.0,0,0.0,1,0.5
car,654,3,0,0.0,NULL,0,0.0,0,0.0
car,655,2,1,0.5,0.0,1,0.5,0,0.0
car,656,1,0,0.0,NULL,0,0.0,0,0.0
car,657,4,0,0.0,NULL,0,0.0,0,0.0
car,659,2,0,0.0,NULL,0,0.0,0,0.0
car,660,4,0,0.0,NULL,0,0.0,0,0.0
car,661,1,1,1.0,1.0,0,0.0,1,1.0
car,662,1,0,0.0,NULL,0,0.0,0,0.0
car,663,1,0,0.0,NULL,0,0.0,0,0.0
car,664,3,0,0.0,NULL,0,0.0,0,0.0
car,665,1,1,1.0,0.0,1,1.0,0,0.0
car,666,2,0,0.0,NULL,0,0.0,0,0.0
car,667,1,0,0.0,NULL,0,0.0,0,0.0
car,668,4,0,0.0,NULL,0,0.0,0,0.0
car,669,4,0,0.0,NULL,0,0.0,0,0.0
car,670,2,0,0.0,NULL,0,0.0,0,0.0
car,671,3,0,0.0,NULL,0,0.0,0,0.0
car,673,4,0,0.0,NULL,0,0.0,0,0.0
car,674,4,0,0.0,NULL,0,0.0,0,0.0
car,675,2,1,0.5,1.0,0,0.0,1,0.5
car,676,2,0,0.0,NULL,0,0.0,0,0.0
car,677,2,0,0.0,NULL,0,0.0,0,0.0
car,678,3,0,0.0,NULL,0,0.0,0,0.0
car,680,3,1,0.333333333333,0.0,1,0.333333333333,0,0.0
car,681,7,3,0.428571428571,0.333333333333,2,0.285714285714,1,0.142857142857
car,682,1,0,0.0,NULL,0,0.0,0,0.0
car,683,2,0,0.0,NULL,0,0.0,0,0.0
car,684,2,0,0.0,NULL,0,0.0,0,0.0
car,685,4,0,0.0,NULL,0,0.0,0,0.0
car,686,4,1,0.25,0.0,1,0.25,0,0.0
car,687,2,2,1.0,0.0,2,1.0,0,0.0
car,688,2,1,0.5,1.0,0,0.0,1,0.5
car,689,4,1,0.25,0.0,1,0.25,0,0.0
car,690,2,0,0.0,NULL,0,0.0,0,0.0
car,691,1,0,0.0,NULL,0,0.0,0,0.0
car,692,5,3,0.6,0.666666666667,1,0.2,2,0.4
car,693,1,1,1.0,0.0,1,1.0,0,0.0
car,694,5,2,0.4,0.5,1,0.2,1,0.2
car,696,2,1,0.5,0.0,1,0.5,0,0.0
car,697,1,0,0.0,NULL,0,0.0,0,0.0
car,698,2,0,0.0,NULL,0,0.0,0,0.0
car,700,3,1,0.333333333333,1.0,0,0.0,1,0.333333333333
car,701,4,1,0.25,0.0,1,0.25,0,0.0
car,702,4,0,0.0,NULL,0,0.0,0,0.0
car,703,2,1,0.5,0.0,1,0.5,0,0.0
car,704,6,1,0.166666666667,1.0,0,0.0,1,0.166666666667
car,705,1,0,0.0,NULL,0,0.0,0,0.0
car,707,1,0,0.0,NULL,0,0.0,0,0.0
car,708,4,0,0.0,NULL,0,0.0,0,0.0
car,709,1,0,0.0,NULL,0,0.0,0,0.0
car,711,1,0,0.0,NULL,0,0.0,0,0.0
car,713,2,0,0.0,NULL,0,0.0,0,0.0
car,714,2,0,0.0,NULL,0,0.0,0,0.0
car,715,2,0,0.0,NULL,0,0.0,0,0.0
car,716,2,2,1.0,0.5,1,0.5,1,0.5
car,717,1,0,0.0,NULL,0,0.0,0,0.0
car,718,3,1,0.333333333333,0.0,1,0.333333333333,0,0.0
car,719,2,1,0.5,1.0,0,0.0,1,0.5
car,720,5,1,0.2,0.0,1,0.2,0,0.0
car,721,2,0,0.0,NULL,0,0.0,0,0.0
car,722,2,0,0.0,NULL,0,0.0,0,0.0
car,723,2,0,0.0,NULL,0,0.0,0,0.0
car,725,3,0,0.0,NULL,0,0.0,0,0.0
car,726,4,0,0.0,NULL,0,0.0,0,0.0
car,727,3,1,0.333333333333,1.0,0,0.0,1,0.333333333333
car,728,1,0,0.0,NULL,0,0.0,0,0.0
car,729,1,0,0.0,NULL,0,0.0,0,0.0
car,731,3,0,0.0,NULL,0,0.0,0,0.0
car,733,1,0,0.0,NULL,0,0.0,0,0.0
car,734,2,1,0.5,1.0,0,0.0,1,0.5
car,735,2,1,0.5,1.0,0,0.0,1,0.5
car,736,1,0,0.0,NULL,0,0.0,0,0.0
car,737,2,1,0.5,1.0,0,0.0,1,0.5
car,738,3,1,0.333333333333,0.0,1,0.333333333333,0,0.0
car,739,2,0,0.0,NULL,0,0.0,0,0.0
car,740,2,0,0.0,NULL,0,0.0,0,0.0
car,741,1,0,0.0,NULL,0,0.0,0,0.0
car,742,2,0,0.0,NULL,0,0.0,0,0.0
car,743,1,0,0.0,NULL,0,0.0,0,0.0
car,744,2,0,0.0,NULL,0,0.0,0,0.0
car,745,2,1,0.5,1.0,0,0.0,1,0.5
car,746,2,0,0.0,NULL,0,0.0,0,0.0
car,747,1,0,0.0,NULL,0,0.0,0,0.0
car,749,2,0,0.0,NULL,0,0.0,0,0.0
car,750,1,0,0.0,NULL,0,0.0,0,0.0
car,751,2,0,0.0,NULL,0,0.0,0,0.0
car,752,3,1,0.333333333333,1.0,0,0.0,1,0.333333333333
car,753,3,0,0.0,NULL,0,0.0,0,0.0
car,754,1,0,0.0,NULL,0,0.0,0,0.0
car,757,3,1,0.333333333333,1.0,0,0.0,1,0.333333333333
car,758,1,1,1.0,1.0,0,0.0,1,1.0
car,759,4,0,0.0,NULL,0,0.0,0,0.0
car,760,3,0,0.0,NULL,0,0.0,0,0.0
car,761,2,1,0.5,0.0,1,0.5,0,0.0
car,762,2,0,0.0,NULL,0,0.0,0,0.0
car,763,1,0,0.0,NULL,0,0.0,0,0.0
car,765,3,0,0.0,NULL,0,0.0,0,0.0
car,766,4,0,0.0,NULL,0,0.0,0,0.0
car,768,2,0,0.0,NULL,0,0.0,0,0.0
car,771,5,1,0.2,1.0,0,0.0,1,0.2
car,772,2,0,0.0,NULL,0,0.0,0,0.0
car,773,1,0,0.0,NULL,0,0.0,0,0.0
car,776,1,0,0.0,NULL,0,0.0,0,0.0
car,778,3,1,0.333333333333,1.0,0,0.0,1,0.333333333333
car,779,1,0,0.0,NULL,0,0.0,0,0.0
car,780,3,0,0.0,NULL,0,0.0,0,0.0
car,781,2,0,0.0,NULL,0,0.0,0,0.0
car,782,3,0,0.0,NULL,0,0.0,0,0.0
car,783,3,1,0.333333333333,1.0,0,0.0,1,0.333333333333
car,786,2,0,0.0,NULL,0,0.0,0,0.0
car,787,3,0,0.0,NULL,0,0.0,0,0.0
car,788,2,0,0.0,NULL,0,0.0,0,0.0
car,789,1,0,0.0,NULL,0,0.0,0,0.0
car,790,4,0,0.0,NULL,0,0.0,0,0.0
car,791,1,0,0.0,NULL,0,0.0,0,0.0
car,792,1,0,0.0,NULL,0,0.0,0,0.0
car,793,1,0,0.0,NULL,0,0.0,0,0.0
car,794,2,0,0.0,NULL,0,0.0,0,0.0
car,796,1,0,0.0,NULL,0,0.0,0,0.0
car,797,1,0,0.0,NULL,0,0.0,0,0.0
car,798,4,1,0.25,1.0,0,0.0,1,0.25
car,799,3,1,0.333333333333,1.0,0,0.0,1,0.333333333333
car,800,1,0,0.0,NULL,0,0.0,0,0.0
car,801,1,0,0.0,NULL,0,0.0,0,0.0
car,802,1,0,0.0,NULL,0,0.0,0,0.0
car,804,2,0,0.0,NULL,0,0.0,0,0.0
car,805,1,0,0.0,NULL,0,0.0,0,0.0
car,806,1,0,0.0,NULL,0,0.0,0,0.0
car,807,3,0,0.0,NULL,0,0.0,0,0.0
car,808,3,0,0.0,NULL,0,0.0,0,0.0
car,809,1,0,0.0,NULL,0,0.0,0,0.0
car,810,3,0,0.0,NULL,0,0.0,0,0.0
car,811,1,0,0.0,NULL,0,0.0,0,0.0
car,814,1,0,0.0,NULL,0,0.0,0,0.0
car,815,3,1,0.333333333333,1.0,0,0.0,1,0.333333333333
car,816,1,0,0.0,NULL,0,0.0,0,0.0
car,817,2,0,0.0,NULL,0,0.0,0,0.0
car,818,3,1,0.333333333333,1.0,0,0.0,1,0.333333333333
car,820,3,0,0.0,NULL,0,0.0,0,0.0
car,821,1,0,0.0,NULL,0,0.0,0,0.0
car,822,3,0,0.0,NULL,0,0.0,0,0.0
car,823,1,0,0.0,NULL,0,0.0,0,0.0
car,824,1,0,0.0,NULL,0,0.0,0,0.0
car,825,1,0,0.0,NULL,0,0.0,0,0.0
car,826,1,0,0.0,NULL,0,0.0,0,0.0
car,827,2,0,0.0,NULL,0,0.0,0,0.0
car,828,2,1,0.5,0.0,1,0.5,0,0.0
car,830,1,0,0.0,NULL,0,0.0,0,0.0
car,831,1,1,1.0,1.0,0,0.0,1,1.0
car,832,2,0,0.0,NULL,0,0.0,0,0.0
car,833,1,0,0.0,NULL,0,0.0,0,0.0
car,834,2,2,1.0,1.0,0,0.0,2,1.0
car,835,2,0,0.0,NULL,0,0.0,0,0.0
car,837,3,0,0.0,NULL,0,0.0,0,0.0
car,840,4,0,0.0,NULL,0,0.0,0,0.0
car,841,3,0,0.0,NULL,0,0.0,0,0.0
car,842,1,1,1.0,1.0,0,0.0,1,1.0
car,844,1,0,0.0,NULL,0,0.0,0,0.0
car,845,1,0,0.0,NULL,0,0.0,0,0.0
car,846,2,0,0.0,NULL,0,0.0,0,0.0
car,847,2,2,1.0,1.0,0,0.0,2,1.0
car,848,1,0,0.0,NULL,0,0.0,0,0.0
car,849,1,0,0.0,NULL,0,0.0,0,0.0
car,850,2,0,0.0,NULL,0,0.0,0,0.0
car,853,1,0,0.0,NULL,0,0.0,0,0.0
car,855,4,1,0.25,1.0,0,0.0,1,0.25
car,858,1,0,0.0,NULL,0,0.0,0,0.0
car,860,2,0,0.0,NULL,0,0.0,0,0.0
car,861,1,0,0.0,NULL,0,0.0,0,0.0
car,862,1,0,0.0,NULL,0,0.0,0,0.0
car,864,2,1,0.5,0.0,1,0.5,0,0.0
car,865,1,0,0.0,NULL,0,0.0,0,0.0
car,866,1,0,0.0,NULL,0,0.0,0,0.0
car,867,3,2,0.666666666667,0.0,2,0.666666666667,0,0.0
car,868,1,0,0.0,NULL,0,0.0,0,0.0
car,869,2,0,0.0,NULL,0,0.0,0,0.0
car,872,2,0,0.0,NULL,0,0.0,0,0.0
car,874,2,0,0.0,NULL,0,0.0,0,0.0
car,875,1,1,1.0,0.0,1,1.0,0,0.0
car,878,2,0,0.0,NULL,0,0.0,0,0.0
car,880,2,0,0.0,NULL,0,0.0,0,0.0
car,884,2,2,1.0,0.0,2,1.0,0,0.0
car,886,1,0,0.0,NULL,0,0.0,0,0.0
car,889,1,0,0.0,NULL,0,0.0,0,0.0
car,891,3,0,0.0,NULL,0,0.0,0,0.0
car,893,3,0,0.0,NULL,0,0.0,0,0.0
car,894,1,0,0.0,NULL,0,0.0,0,0.0
car,895,2,0,0.0,NULL,0,0.0,0,0.0
car,896,1,0,0.0,NULL,0,0.0,0,0.0
car,897,1,0,0.0,NULL,0,0.0,0,0.0
car,900,2,1,0.5,0.0,1,0.5,0,0.0
car,902,1,0,0.0,NULL,0,0.0,0,0.0
car,903,4,1,0.25,0.0,1,0.25,0,0.0
car,904,2,0,0.0,NULL,0,0.0,0,0.0
car,905,1,1,1.0,1.0,0,0.0,1,1.0
car,906,2,1,0.5,1.0,0,0.0,1,0.5
car,911,2,0,0.0,NULL,0,0.0,0,0.0
car,912,1,0,0.0,NULL,0,0.0,0,0.0
car,916,2,0,0.0,NULL,0,0.0,0,0.0
car,921,1,0,0.0,NULL,0,0.0,0,0.0
car,924,1,0,0.0,NULL,0,0.0,0,0.0
car,925,1,0,0.0,NULL,0,0.0,0,0.0
car,926,1,0,0.0,NULL,0,0.0,0,0.0
car,927,1,0,0.0,NULL,0,0.0,0,0.0
car,930,2,0,0.0,NULL,0,0.0,0,0.0
car,932,3,0,0.0,NULL,0,0.0,0,0.0
car,933,2,1,0.5,1.0,0,0.0,1,0.5
car,934,4,2,0.5,0.5,1,0.25,1,0.25
car,936,1,0,0.0,NULL,0,0.0,0,0.0
car,940,1,0,0.0,NULL,0,0.0,0,0.0
car,941,1,0,0.0,NULL,0,0.0,0,0.0
car,942,3,1,0.333333333333,0.0,1,0.333333333333,0,0.0
car,944,1,1,1.0,0.0,1,1.0,0,0.0
car,945,1,0,0.0,NULL,0,0.0,0,0.0
car,947,2,0,0.0,NULL,0,0.0,0,0.0
car,948,2,0,0.0,NULL,0,0.0,0,0.0
car,950,1,0,0.0,NULL,0,0.0,0,0.0
car,953,1,0,0.0,NULL,0,0.0,0,0.0
car,955,1,0,0.0,NULL,0,0.0,0,0.0
car,957,3,0,0.0,NULL,0,0.0,0,0.0
car,960,1,0,0.0,NULL,0,0.0,0,0.0
car,961,1,0,0.0,NULL,0,0.0,0,0.0
car,963,1,0,0.0,NULL,0,0.0,0,0.0
car,965,2,0,0.0,NULL,0,0.0,0,0.0
car,967,2,1,0.5,1.0,0,0.0,1,0.5
car,968,2,1,0.5,1.0,0,0.0,1,0.5
car,969,2,0,0.0,NULL,0,0.0,0,0.0
car,972,1,0,0.0,NULL,0,0.0,0,0.0
car,973,2,1,0.5,0.0,1,0.5,0,0.0
car,974,3,1,0.333333333333,0.0,1,0.333333333333,0,0.0
car,975,1,1,1.0,0.0,1,1.0,0,0.0
car,979,1,0,0.0,NULL,0,0.0,0,0.0
car,980,2,1,0.5,1.0,0,0.0,1,0.5
car,982,1,0,0.0,NULL,0,0.0,0,0.0
car,984,1,0,0.0,NULL,0,0.0,0,0.0
car,985,1,0,0.0,NULL,0,0.0,0,0.0
car,986,1,1,1.0,0.0,1,1.0,0,0.0
car,990,2,0,0.0,NULL,0,0.0,0,0.0
car,994,1,0,0.0,NULL,0,0.0,0,0.0
car,999,1,0,0.0,NULL,0,0.0,0,0.0
car,1003,1,0,0.0,NULL,0,0.0,0,0.0
car,1004,2,1,0.5,0.0,1,0.5,0,0.0
car,1008,2,1,0.5,0.0,1,0.5,0,0.0
car,1009,4,0,0.0,NULL,0,0.0,0,0.0
car,1010,1,0,0.0,NULL,0,0.0,0,0.0
car,1012,1,1,1.0,0.0,1,1.0,0,0.0
car,1014,2,0,0.0,NULL,0,0.0,0,0.0
car,1015,1,0,0.0,NULL,0,0.0,0,0.0
car,1016,1,1,1.0,1.0,0,0.0,1,1.0
car,1019,1,0,0.0,NULL,0,0.0,0,0.0
car,1023,1,0,0.0,NULL,0,0.0,0,0.0
car,1027,1,0,0.0,NULL,0,0.0,0,0.0
car,1028,1,0,0.0,NULL,0,0.0,0,0.0
car,1030,2,1,0.5,1.0,0,0.0,1,0.5
car,1031,2,0,0.0,NULL,0,0.0,0,0.0
car,1033,1,0,0.0,NULL,0,0.0,0,0.0
car,1036,1,0,0.0,NULL,0,0.0,0,0.0
car,1037,1,0,0.0,NULL,0,0.0,0,0.0
car,1039,2,1,0.5,0.0,1,0.5,0,0.0
car,1042,1,0,0.0,NULL,0,0.0,0,0.0
car,1044,1,0,0.0,NULL,0,0.0,0,0.0
car,1048,1,0,0.0,NULL,0,0.0,0,0.0
car,1051,3,0,0.0,NULL,0,0.0,0,0.0
car,1053,1,0,0.0,NULL,0,0.0,0,0.0
car,1054,2,0,0.0,NULL,0,0.0,0,0.0
car,1055,1,0,0.0,NULL,0,0.0,0,0.0
car,1056,2,0,0.0,NULL,0,0.0,0,0.0
car,1057,2,1,0.5,0.0,1,0.5,0,0.0
car,1058,1,0,0.0,NULL,0,0.0,0,0.0
car,1059,1,0,0.0,NULL,0,0.0,0,0.0
car,1061,2,0,0.0,NULL,0,0.0,0,0.0
car,1062,2,0,0.0,NULL,0,0.0,0,0.0
car,1064,1,0,0.0,NULL,0,0.0,0,0.0
car,1065,1,0,0.0,NULL,0,0.0,0,0.0
car,1066,1,0,0.0,NULL,0,0.0,0,0.0
car,1067,1,1,1.0,0.0,1,1.0,0,0.0
car,1070,1,0,0.0,NULL,0,0.0,0,0.0
car,1071,1,0,0.0,NULL,0,0.0,0,0.0
car,1072,1,0,0.0,NULL,0,0.0,0,0.0
car,1079,1,0,0.0,NULL,0,0.0,0,0.0
car,1082,2,1,0.5,0.0,1,0.5,0,0.0
car,1083,1,0,0.0,NULL,0,0.0,0,0.0
car,1087,1,0,0.0,NULL,0,0.0,0,0.0
car,1088,1,0,0.0,NULL,0,0.0,0,0.0
car,1089,1,1,1.0,0.0,1,1.0,0,0.0
car,1090,1,1,1.0,1.0,0,0.0,1,1.0
car,1092,1,0,0.0,NULL,0,0.0,0,0.0
car,1093,1,0,0.0,NULL,0,0.0,0,0.0
car,1094,1,0,0.0,NULL,0,0.0,0,0.0
car,1095,3,0,0.0,NULL,0,0.0,0,0.0
car,1098,1,0,0.0,NULL,0,0.0,0,0.0
car,1101,3,0,0.0,NULL,0,0.0,0,0.0
car,1103,1,0,0.0,NULL,0,0.0,0,0.0
car,1105,1,1,1.0,1.0,0,0.0,1,1.0
car,1106,3,0,0.0,NULL,0,0.0,0,0.0
car,1109,1,0,0.0,NULL,0,0.0,0,0.0
car,1111,1,0,0.0,NULL,0,0.0,0,0.0
car,1112,1,0,0.0,NULL,0,0.0,0,0.0
car,1113,1,0,0.0,NULL,0,0.0,0,0.0
car,1114,1,0,0.0,NULL,0,0.0,0,0.0
car,1115,1,0,0.0,NULL,0,0.0,0,0.0
car,1116,2,0,0.0,NULL,0,0.0,0,0.0
car,1118,1,0,0.0,NULL,0,0.0,0,0.0
car,1119,1,1,1.0,0.0,1,1.0,0,0.0
car,1120,1,0,0.0,NULL,0,0.0,0,0.0
car,1121,1,0,0.0,NULL,0,0.0,0,0.0
car,1122,2,0,0.0,NULL,0,0.0,0,0.0
car,1124,2,0,0.0,NULL,0,0.0,0,0.0
car,1126,2,1,0.5,1.0,0,0.0,1,0.5
car,1128,2,1,0.5,1.0,0,0.0,1,0.5
car,1132,1,0,0.0,NULL,0,0.0,0,0.0
car,1135,1,0,0.0,NULL,0,0.0,0,0.0
car,1137,3,0,0.0,NULL,0,0.0,0,0.0
car,1138,1,1,1.0,1.0,0,0.0,1,1.0
car,1139,2,0,0.0,NULL,0,0.0,0,0.0
car,1140,1,0,0.0,NULL,0,0.0,0,0.0
car,1141,1,1,1.0,1.0,0,0.0,1,1.0
car,1144,1,0,0.0,NULL,0,0.0,0,0.0
car,1145,1,0,0.0,NULL,0,0.0,0,0.0
car,1149,1,0,0.0,NULL,0,0.0,0,0.0
car,1150,1,0,0.0,NULL,0,0.0,0,0.0
car,1152,1,0,0.0,NULL,0,0.0,0,0.0
car,1153,1,0,0.0,NULL,0,0.0,0,0.0
car,1156,1,1,1.0,1.0,0,0.0,1,1.0
car,1157,1,0,0.0,NULL,0,0.0,0,0.0
car,1161,1,0,0.0,NULL,0,0.0,0,0.0
car,1164,1,0,0.0,NULL,0,0.0,0,0.0
car,1165,1,1,1.0,0.0,1,1.0,0,0.0
car,1171,1,0,0.0,NULL,0,0.0,0,0.0
car,1172,1,0,0.0,NULL,0,0.0,0,0.0
car,1178,2,0,0.0,NULL,0,0.0,0,0.0
car,1182,1,0,0.0,NULL,0,0.0,0,0.0
car,1185,3,0,0.0,NULL,0,0.0,0,0.0
car,1186,1,0,0.0,NULL,0,0.0,0,0.0
car,1188,1,0,0.0,NULL,0,0.0,0,0.0
car,1197,1,0,0.0,NULL,0,0.0,0,0.0
car,1203,1,0,0.0,NULL,0,0.0,0,0.0
car,1205,1,0,0.0,NULL,0,0.0,0,0.0
car,1208,1,0,0.0,NULL,0,0.0,0,0.0
car,1210,1,0,0.0,NULL,0,0.0,0,0.0
car,1220,1,0,0.0,NULL,0,0.0,0,0.0
car,1225,1,0,0.0,NULL,0,0.0,0,0.0
car,1226,2,0,0.0,NULL,0,0.0,0,0.0
car,1229,2,0,0.0,NULL,0,0.0,0,0.0
car,1239,1,0,0.0,NULL,0,0.0,0,0.0
car,1242,1,1,1.0,1.0,0,0.0,1,1.0
car,1244,1,0,0.0,NULL,0,0.0,0,0.0
car,1245,1,0,0.0,NULL,0,0.0,0,0.0
car,1247,1,1,1.0,0.0,1,1.0,0,0.0
car,1249,1,0,0.0,NULL,0,0.0,0,0.0
car,1252,1,0,0.0,NULL,0,0.0,0,0.0
car,1253,1,1,1.0,0.0,1,1.0,0,0.0
car,1255,1,0,0.0,NULL,0,0.0,0,0.0
car,1256,1,1,1.0,0.0,1,1.0,0,0.0
car,1258,1,0,0.0,NULL,0,0.0,0,0.0
car,1259,1,0,0.0,NULL,0,0.0,0,0.0
car,1264,1,0,0.0,NULL,0,0.0,0,0.0
car,1277,1,1,1.0,1.0,0,0.0,1,1.0
car,1282,1,0,0.0,NULL,0,0.0,0,0.0
car,1286,1,0,0.0,NULL,0,0.0,0,0.0
car,1292,1,0,0.0,NULL,0,0.0,0,0.0
car,1294,1,0,0.0,NULL,0,0.0,0,0.0
car,1296,1,1,1.0,1.0,0,0.0,1,1.0
car,1299,1,0,0.0,NULL,0,0.0,0,0.0
car,1303,2,0,0.0,NULL,0,0.0,0,0.0
car,1309,2,0,0.0,NULL,0,0.0,0,0.0
car,1313,1,0,0.0,NULL,0,0.0,0,0.0
car,1315,1,0,0.0,NULL,0,0.0,0,0.0
car,1317,1,0,0.0,NULL,0,0.0,0,0.0
car,1323,1,0,0.0,NULL,0,0.0,0,0.0
car,1324,1,0,0.0,NULL,0,0.0,0,0.0
car,1326,1,0,0.0,NULL,0,0.0,0,0.0
car,1333,1,0,0.0,NULL,0,0.0,0,0.0
car,1343,2,1,0.5,1.0,0,0.0,1,0.5
car,1344,1,0,0.0,NULL,0,0.0,0,0.0
car,1351,1,0,0.0,NULL,0,0.0,0,0.0
car,1353,1,0,0.0,NULL,0,0.0,0,0.0
car,1354,1,0,0.0,NULL,0,0.0,0,0.0
car,1355,1,0,0.0,NULL,0,0.0,0,0.0
car,1358,2,0,0.0,NULL,0,0.0,0,0.0
car,1363,1,0,0.0,NULL,0,0.0,0,0.0
car,1368,1,1,1.0,1.0,0,0.0,1,1.0
car,1386,1,0,0.0,NULL,0,0.0,0,0.0
car,1388,1,0,0.0,NULL,0,0.0,0,0.0
car,1392,1,0,0.0,NULL,0,0.0,0,0.0
car,1393,1,1,1.0,1.0,0,0.0,1,1.0
car,1397,1,0,0.0,NULL,0,0.0,0,0.0
car,1407,1,0,0.0,NULL,0,0.0,0,0.0
car,1411,1,0,0.0,NULL,0,0.0,0,0.0
car,1413,1,0,0.0,NULL,0,0.0,0,0.0
car,1420,1,0,0.0,NULL,0,0.0,0,0.0
car,1431,1,0,0.0,NULL,0,0.0,0,0.0
car,1435,1,1,1.0,1.0,0,0.0,1,1.0
car,1436,1,1,1.0,1.0,0,0.0,1,1.0
car,1448,1,0,0.0,NULL,0,0.0,0,0.0
car,1449,2,0,0.0,NULL,0,0.0,0,0.0
car,1458,1,0,0.0,NULL,0,0.0,0,0.0
car,1462,2,0,0.0,NULL,0,0.0,0,0.0
car,1463,1,0,0.0,NULL,0,0.0,0,0.0
car,1466,1,0,0.0,NULL,0,0.0,0,0.0
car,1468,1,1,1.0,1.0,0,0.0,1,1.0
car,1484,1,0,0.0,NULL,0,0.0,0,0.0
car,1488,1,0,0.0,NULL,0,0.0,0,0.0
car,1492,1,0,0.0,NULL,0,0.0,0,0.0
car,1496,1,0,0.0,NULL,0,0.0,0,0.0
car,1505,1,0,0.0,NULL,0,0.0,0,0.0
car,1509,1,0,0.0,NULL,0,0.0,0,0.0
car,1510,1,0,0.0,NULL,0,0.0,0,0.0
car,1520,1,0,0.0,NULL,0,0.0,0,0.0
car,1522,1,0,0.0,NULL,0,0.0,0,0.0
car,1523,1,0,0.0,NULL,0,0.0,0,0.0
car,1537,2,0,0.0,NULL,0,0.0,0,0.0
car,1545,1,0,0.0,NULL,0,0.0,0,0.0
car,1557,2,0,0.0,NULL,0,0.0,0,0.0
car,1566,1,0,0.0,NULL,0,0.0,0,0.0
car,1572,1,0,0.0,NULL,0,0.0,0,0.0
car,1573,1,0,0.0,NULL,0,0.0,0,0.0
car,1575,1,0,0.0,NULL,0,0.0,0,0.0
car,1580,2,1,0.5,0.0,1,0.5,0,0.0
car,1589,1,0,0.0,NULL,0,0.0,0,0.0
car,1594,1,0,0.0,NULL,0,0.0,0,0.0
car,1610,1,0,0.0,NULL,0,0.0,0,0.0
car,1616,2,0,0.0,NULL,0,0.0,0,0.0
car,1618,1,0,0.0,NULL,0,0.0,0,0.0
car,1620,1,0,0.0,NULL,0,0.0,0,0.0
car,1621,1,1,1.0,1.0,0,0.0,1,1.0
car,1625,1,0,0.0,NULL,0,0.0,0,0.0
car,1639,1,0,0.0,NULL,0,0.0,0,0.0
car,1654,1,0,0.0,NULL,0,0.0,0,0.0
car,1656,1,0,0.0,NULL,0,0.0,0,0.0
car,1660,1,1,1.0,0.0,1,1.0,0,0.0
car,1664,1,0,0.0,NULL,0,0.0,0,0.0
car,1680,1,0,0.0,NULL,0,0.0,0,0.0
car,1681,1,0,0.0,NULL,0,0.0,0,0.0
car,1689,1,0,0.0,NULL,0,0.0,0,0.0
car,1699,1,0,0.0,NULL,0,0.0,0,0.0
car,1710,1,1,1.0,0.0,1,1.0,0,0.0
car,1711,1,0,0.0,NULL,0,0.0,0,0.0
car,1723,2,1,0.5,0.0,1,0.5,0,0.0
car,1725,1,1,1.0,0.0,1,1.0,0,0.0
car,1727,1,0,0.0,NULL,0,0.0,0,0.0
car,1733,1,0,0.0,NULL,0,0.0,0,0.0
car,1744,1,0,0.0,NULL,0,0.0,0,0.0
car,1755,2,0,0.0,NULL,0,0.0,0,0.0
car,1761,1,0,0.0,NULL,0,0.0,0,0.0
car,1770,1,0,0.0,NULL,0,0.0,0,0.0
car,1773,1,0,0.0,NULL,0,0.0,0,0.0
car,1777,1,0,0.0,NULL,0,0.0,0,0.0
car,1790,1,0,0.0,NULL,0,0.0,0,0.0
car,1799,1,0,0.0,NULL,0,0.0,0,0.0
car,1803,1,0,0.0,NULL,0,0.0,0,0.0
car,1810,1,0,0.0,NULL,0,0.0,0,0.0
car,1825,1,0,0.0,NULL,0,0.0,0,0.0
car,1828,1,0,0.0,NULL,0,0.0,0,0.0
car,1862,2,0,0.0,NULL,0,0.0,0,0.0
car,1864,1,0,0.0,NULL,0,0.0,0,0.0
car,1866,1,0,0.0,NULL,0,0.0,0,0.0
car,1869,1,1,1.0,1.0,0,0.0,1,1.0
car,1874,1,0,0.0,NULL,0,0.0,0,0.0
car,1892,1,0,0.0,NULL,0,0.0,0,0.0
car,1899,1,0,0.0,NULL,0,0.0,0,0.0
car,1901,1,0,0.0,NULL,0,0.0,0,0.0
car,1910,1,0,0.0,NULL,0,0.0,0,0.0
car,1919,1,0,0.0,NULL,0,0.0,0,0.0
car,1922,1,0,0.0,NULL,0,0.0,0,0.0
car,1937,1,0,0.0,NULL,0,0.0,0,0.0
car,1942,2,0,0.0,NULL,0,0.0,0,0.0
car,1948,1,0,0.0,NULL,0,0.0,0,0.0
car,1949,1,0,0.0,NULL,0,0.0,0,0.0
car,1951,2,0,0.0,NULL,0,0.0,0,0.0
car,1966,1,0,0.0,NULL,0,0.0,0,0.0
car,1976,1,0,0.0,NULL,0,0.0,0,0.0
car,1981,1,0,0.0,NULL,0,0.0,0,0.0
car,1982,1,0,0.0,NULL,0,0.0,0,0.0
car,1984,1,0,0.0,NULL,0,0.0,0,0.0
car,1997,1,0,0.0,NULL,0,0.0,0,0.0
car,2005,1,0,0.0,NULL,0,0.0,0,0.0
car,2022,1,1,1.0,0.0,1,1.0,0,0.0
car,2027,1,0,0.0,NULL,0,0.0,0,0.0
car,2037,1,0,0.0,NULL,0,0.0,0,0.0
car,2073,1,0,0.0,NULL,0,0.0,0,0.0
car,2076,1,1,1.0,0.0,1,1.0,0,0.0
car,2116,1,0,0.0,NULL,0,0.0,0,0.0
car,2127,1,0,0.0,NULL,0,0.0,0,0.0
car,2129,1,0,0.0,NULL,0,0.0,0,0.0
car,2143,1,0,0.0,NULL,0,0.0,0,0.0
car,2176,1,0,0.0,NULL,0,0.0,0,0.0
car,2224,1,0,0.0,NULL,0,0.0,0,0.0
car,2236,1,0,0.0,NULL,0,0.0,0,0.0
car,2250,1,0,0.0,NULL,0,0.0,0,0.0
car,2264,1,0,0.0,NULL,0,0.0,0,0.0
car,2269,1,0,0.0,NULL,0,0.0,0,0.0
car,2285,1,0,0.0,NULL,0,0.0,0,0.0
car,2407,1,0,0.0,NULL,0,0.0,0,0.0
car,2421,1,0,0.0,NULL,0,0.0,0,0.0
car,2469,1,0,0.0,NULL,0,0.0,0,0.0
car,2492,1,0,0.0,NULL,0,0.0,0,0.0
car,2514,1,0,0.0,NULL,0,0.0,0,0.0
car,2533,1,0,0.0,NULL,0,0.0,0,0.0
car,2595,1,0,0.0,NULL,0,0.0,0,0.0
car,2619,1,0,0.0,NULL,0,0.0,0,0.0
car,2663,1,0,0.0,NULL,0,0.0,0,0.0
car,2672,1,0,0.0,NULL,0,0.0,0,0.0
car,2673,1,0,0.0,NULL,0,0.0,0,0.0
car,2737,1,0,0.0,NULL,0,0.0,0,0.0
car,2740,1,0,0.0,NULL,0,0.0,0,0.0
car,2753,1,0,0.0,NULL,0,0.0,0,0.0
car,2766,1,0,0.0,NULL,0,0.0,0,0.0
car,2856,1,0,0.0,NULL,0,0.0,0,0.0
car,2863,1,0,0.0,NULL,0,0.0,0,0.0
car,2881,1,0,0.0,NULL,0,0.0,0,0.0
car,2965,1,0,0.0,NULL,0,0.0,0,0.0
car,3083,1,0,0.0,NULL,0,0.0,0,0.0
car,3108,1,1,1.0,1.0,0,0.0,1,1.0
car,3120,1,0,0.0,NULL,0,0.0,0,0.0
car,3121,1,1,1.0,0.0,1,1.0,0,0.0
car,3124,1,0,0.0,NULL,0,0.0,0,0.0
car,3150,1,0,0.0,NULL,0,0.0,0,0.0
car,3160,1,0,0.0,NULL,0,0.0,0,0.0
car,3199,1,0,0.0,NULL,0,0.0,0,0.0
car,3226,1,1,1.0,1.0,0,0.0,1,1.0
car,3231,1,0,0.0,NULL,0,0.0,0,0.0
car,3257,1,0,0.0,NULL,0,0.0,0,0.0
car,3269,1,1,1.0,0.0,1,1.0,0,0.0
car,3522,1,0,0.0,NULL,0,0.0,0,0.0
car,3579,1,0,0.0,NULL,0,0.0,0,0.0
car,3642,1,0,0.0,NULL,0,0.0,0,0.0
car,3670,1,0,0.0,NULL,0,0.0,0,0.0
car,3690,1,0,0.0,NULL,0,0.0,0,0.0
car,3802,1,0,0.0,NULL,0,0.0,0,0.0
car,3928,1,0,0.0,NULL,0,0.0,0,0.0
car,4101,1,0,0.0,NULL,0,0.0,0,0.0
car,4253,1,0,0.0,NULL,0,0.0,0,0.0
car,4339,1,0,0.0,NULL,0,0.0,0,0.0
car,4385,1,0,0.0,NULL,0,0.0,0,0.0
car,4434,1,0,0.0,NULL,0,0.0,0,0.0
car,4443,1,0,0.0,NULL,0,0.0,0,0.0
car,4850,1,0,0.0,NULL,0,0.0,0,0.0
car,7396,1,0,0.0,NULL,0,0.0,0,0.0
car,9108,1,0,0.0,NULL,0,0.0,0,0.0
car,9621,1,1,1.0,1.0,0,0.0,1,1.0
house,0,4295329,231748,0.0539534922703,0.215026666897,181916,0.04235205266,49832,0.0116014396103
house,1,1036801,83756,0.0807831010965,0.267980801375,61311,0.0591347809271,22445,0.0216483201694
house,2,587901,61538,0.104674086283,0.304169781273,42820,0.0728353923535,18718,0.0318386939298
house,3,349867,42045,0.120174237639,0.335045784279,27958,0.0799103659391,14087,0.0402638716998
house,4,249113,33821,0.135765696692,0.356346648532,21769,0.0873860456901,12052,0.0483796510018
house,5,172687,25375,0.14694215546,0.37954679803,15744,0.0911707308599,9631,0.0557714246006
house,6,137107,21462,0.156534677296,0.395629484671,12971,0.0946049435842,8491,0.0619297337116
house,7,101965,16751,0.164281861423,0.411079935526,9865,0.0967488844211,6886,0.0675329770019
house,8,84146,14168,0.16837401659,0.42518351214,8144,0.0967841608633,6024,0.071589855727
house,9,65941,11642,0.176551765973,0.441333104278,6504,0.0986336270302,5138,0.0779181389424
house,10,55437,10291,0.185634143262,0.448935963463,5671,0.102296300305,4620,0.0833378429569
house,11,44820,8659,0.193195002231,0.452015244255,4745,0.105867916109,3914,0.0873270861223
house,12,39200,7619,0.194362244898,0.463052894081,4091,0.104362244898,3528,0.09
house,13,32552,6600,0.202752519046,0.462424242424,3548,0.108994839027,3052,0.0937576800197
house,14,28814,5879,0.204032761852,0.480523898622,3054,0.10599014368,2825,0.0980426181717
house,15,24669,5081,0.205967003121,0.487502460146,2604,0.105557582391,2477,0.10040942073
house,16,21883,4658,0.212859297171,0.495491627308,2350,0.107389297628,2308,0.105469999543
house,17,18547,4025,0.21701622904,0.493416149068,2039,0.109936917022,1986,0.107079312018
house,18,17368,3957,0.227832795947,0.466262319939,2112,0.12160294795,1845,0.106229847996
house,19,14618,3164,0.216445478178,0.526864728192,1497,0.102407990149,1667,0.114037488028
house,20,12943,2837,0.21919184115,0.512513218188,1383,0.106853125241,1454,0.112338715908
house,21,11771,2616,0.222241101011,0.509556574924,1283,0.108996686773,1333,0.113244414238
house,22,10701,2311,0.215961125128,0.504543487668,1145,0.106999345856,1166,0.108961779273
house,23,9349,2074,0.221841908225,0.533269045323,968,0.103540485613,1106,0.118301422612
house,24,8707,1967,0.225910187206,0.51398068124,956,0.109796715287,1011,0.116113471919
house,25,7642,1766,0.231091337346,0.534541336353,822,0.107563465062,944,0.123527872285
house,26,6977,1589,0.227748315895,0.52485840151,755,0.108212698868,834,0.119535617027
house,27,6470,1479,0.228593508501,0.554428668019,659,0.101854714065,820,0.126738794436
house,28,6101,1384,0.226848057695,0.55563583815,615,0.100803147025,769,0.12604491067
house,29,5350,1192,0.222803738318,0.551174496644,535,0.1,657,0.122803738318
house,30,4992,1148,0.229967948718,0.564459930314,500,0.10016025641,648,0.129807692308
house,31,4495,1082,0.240711902113,0.560073937153,476,0.105895439377,606,0.134816462736
house,32,4240,947,0.223349056604,0.537486800422,438,0.103301886792,509,0.120047169811
house,33,3937,930,0.236220472441,0.587096774194,384,0.0975361950724,546,0.138684277369
house,34,3607,887,0.245910729138,0.531003382187,416,0.11533130025,471,0.130579428888
house,35,3326,789,0.237221888154,0.553865652725,352,0.105832832231,437,0.131389055923
house,36,3033,698,0.23013517969,0.540114613181,321,0.105835806133,377,0.124299373558
house,37,2880,652,0.226388888889,0.569018404908,281,0.0975694444444,371,0.128819444444
house,38,2662,584,0.219383921863,0.606164383562,230,0.0864012021037,354,0.13298271976
house,39,2459,552,0.224481496543,0.559782608696,243,0.0988206588044,309,0.125660837739
house,40,2345,533,0.227292110874,0.59287054409,217,0.0925373134328,316,0.134754797441
house,41,2169,535,0.246657445828,0.545794392523,243,0.112033195021,292,0.134624250807
house,42,2021,471,0.233052944087,0.577494692144,199,0.0984661058882,272,0.134586838199
house,43,1923,445,0.23140925637,0.532584269663,208,0.108164326573,237,0.123244929797
house,44,1889,470,0.248808893594,0.555319148936,209,0.110640550556,261,0.138168343039
house,45,1706,388,0.227432590856,0.600515463918,155,0.0908558030481,233,0.136576787808
house,46,1695,387,0.228318584071,0.581395348837,162,0.0955752212389,225,0.132743362832
house,47,1551,360,0.232108317215,0.558333333333,159,0.10251450677,201,0.129593810445
house,48,1483,346,0.233310856372,0.546242774566,157,0.105866486851,189,0.127444369521
house,49,1357,296,0.218128224024,0.597972972973,119,0.0876934414149,177,0.130434782609
house,50,1328,326,0.245481927711,0.561349693252,143,0.107680722892,183,0.137801204819
house,51,1337,325,0.243081525804,0.587692307692,134,0.100224382947,191,0.142857142857
house,52,1166,286,0.245283018868,0.646853146853,101,0.0866209262436,185,0.158662092624
house,53,1039,234,0.225216554379,0.529914529915,110,0.105871029836,124,0.119345524543
house,54,1080,256,0.237037037037,0.55859375,113,0.10462962963,143,0.132407407407
house,55,1064,263,0.247180451128,0.562737642586,115,0.108082706767,148,0.139097744361
house,56,980,221,0.225510204082,0.606334841629,87,0.0887755102041,134,0.136734693878
house,57,939,202,0.215122470714,0.554455445545,90,0.0958466453674,112,0.119275825346
house,58,868,214,0.246543778802,0.528037383178,101,0.116359447005,113,0.130184331797
house,59,772,193,0.25,0.60621761658,76,0.0984455958549,117,0.151554404145
house,60,784,172,0.219387755102,0.523255813953,82,0.104591836735,90,0.114795918367
house,61,768,173,0.225260416667,0.531791907514,81,0.10546875,92,0.119791666667
house,62,692,156,0.225433526012,0.621794871795,59,0.0852601156069,97,0.140173410405
house,63,654,153,0.233944954128,0.529411764706,72,0.110091743119,81,0.123853211009
house,64,655,139,0.212213740458,0.589928057554,57,0.0870229007634,82,0.125190839695
house,65,649,149,0.229583975347,0.563758389262,65,0.100154083205,84,0.129429892142
house,66,640,161,0.2515625,0.577639751553,68,0.10625,93,0.1453125
house,67,565,118,0.208849557522,0.576271186441,50,0.0884955752212,68,0.120353982301
house,68,527,125,0.237191650854,0.616,48,0.0910815939279,77,0.146110056926
house,69,497,122,0.245472837022,0.581967213115,51,0.102615694165,71,0.142857142857
house,70,507,118,0.232741617357,0.610169491525,46,0.0907297830375,72,0.14201183432
house,71,498,94,0.18875502008,0.595744680851,38,0.0763052208835,56,0.112449799197
house,72,510,112,0.219607843137,0.455357142857,61,0.119607843137,51,0.1
house,73,416,110,0.264423076923,0.590909090909,45,0.108173076923,65,0.15625
house,74,471,98,0.208067940552,0.69387755102,30,0.0636942675159,68,0.144373673036
house,75,400,99,0.2475,0.636363636364,36,0.09,63,0.1575
house,76,393,82,0.208651399491,0.536585365854,38,0.0966921119593,44,0.111959287532
house,77,390,89,0.228205128205,0.629213483146,33,0.0846153846154,56,0.14358974359
house,78,370,78,0.210810810811,0.589743589744,32,0.0864864864865,46,0.124324324324
house,79,352,81,0.230113636364,0.493827160494,41,0.116477272727,40,0.113636363636
house,80,350,72,0.205714285714,0.666666666667,24,0.0685714285714,48,0.137142857143
house,81,344,82,0.238372093023,0.59756097561,33,0.0959302325581,49,0.142441860465
house,82,328,64,0.19512195122,0.625,24,0.0731707317073,40,0.121951219512
house,83,329,75,0.227963525836,0.666666666667,25,0.0759878419453,50,0.151975683891
house,84,299,63,0.210702341137,0.619047619048,24,0.0802675585284,39,0.130434782609
house,85,275,62,0.225454545455,0.596774193548,25,0.0909090909091,37,0.134545454545
house,86,274,58,0.211678832117,0.51724137931,28,0.102189781022,30,0.109489051095
house,87,229,61,0.266375545852,0.491803278689,31,0.135371179039,30,0.131004366812
house,88,271,60,0.221402214022,0.483333333333,31,0.114391143911,29,0.107011070111
house,89,268,56,0.208955223881,0.571428571429,24,0.089552238806,32,0.119402985075
house,90,263,54,0.205323193916,0.611111111111,21,0.0798479087452,33,0.125475285171
house,91,218,48,0.220183486239,0.583333333333,20,0.0917431192661,28,0.128440366972
house,92,231,45,0.194805194805,0.466666666667,24,0.103896103896,21,0.0909090909091
house,93,219,52,0.237442922374,0.596153846154,21,0.0958904109589,31,0.141552511416
house,94,248,40,0.161290322581,0.5,20,0.0806451612903,20,0.0806451612903
house,95,184,38,0.20652173913,0.447368421053,21,0.114130434783,17,0.0923913043478
house,96,221,52,0.235294117647,0.576923076923,22,0.0995475113122,30,0.135746606335
house,97,205,55,0.268292682927,0.545454545455,25,0.121951219512,30,0.146341463415
house,98,197,48,0.243654822335,0.604166666667,19,0.0964467005076,29,0.147208121827
house,99,195,38,0.194871794872,0.5,19,0.0974358974359,19,0.0974358974359
house,100,206,49,0.23786407767,0.632653061224,18,0.0873786407767,31,0.150485436893
house,101,182,38,0.208791208791,0.552631578947,17,0.0934065934066,21,0.115384615385
house,102,172,40,0.232558139535,0.45,22,0.127906976744,18,0.104651162791
house,103,176,40,0.227272727273,0.425,23,0.130681818182,17,0.0965909090909
house,104,151,27,0.17880794702,0.62962962963,10,0.0662251655629,17,0.112582781457
house,105,153,22,0.143790849673,0.681818181818,7,0.0457516339869,15,0.0980392156863
house,106,142,22,0.154929577465,0.727272727273,6,0.0422535211268,16,0.112676056338
house,107,139,24,0.172661870504,0.5,12,0.0863309352518,12,0.0863309352518
house,108,133,29,0.218045112782,0.689655172414,9,0.0676691729323,20,0.15037593985
house,109,125,27,0.216,0.777777777778,6,0.048,21,0.168
house,110,121,26,0.214876033058,0.653846153846,9,0.0743801652893,17,0.140495867769
house,111,119,24,0.201680672269,0.625,9,0.0756302521008,15,0.126050420168
house,112,154,25,0.162337662338,0.56,11,0.0714285714286,14,0.0909090909091
house,113,130,36,0.276923076923,0.666666666667,12,0.0923076923077,24,0.184615384615
house,114,127,25,0.196850393701,0.44,14,0.110236220472,11,0.0866141732283
house,115,122,30,0.245901639344,0.566666666667,13,0.106557377049,17,0.139344262295
house,116,120,29,0.241666666667,0.586206896552,12,0.1,17,0.141666666667
house,117,116,28,0.241379310345,0.678571428571,9,0.0775862068966,19,0.163793103448
house,118,107,28,0.261682242991,0.5,14,0.130841121495,14,0.130841121495
house,119,116,34,0.293103448276,0.529411764706,16,0.137931034483,18,0.155172413793
house,120,102,19,0.186274509804,0.368421052632,12,0.117647058824,7,0.0686274509804
house,121,104,13,0.125,0.538461538462,6,0.0576923076923,7,0.0673076923077
house,122,97,14,0.144329896907,0.714285714286,4,0.0412371134021,10,0.103092783505
house,123,112,23,0.205357142857,0.478260869565,12,0.107142857143,11,0.0982142857143
house,124,81,18,0.222222222222,0.611111111111,7,0.0864197530864,11,0.135802469136
house,125,70,15,0.214285714286,0.666666666667,5,0.0714285714286,10,0.142857142857
house,126,72,16,0.222222222222,0.5,8,0.111111111111,8,0.111111111111
house,127,108,16,0.148148148148,0.4375,9,0.0833333333333,7,0.0648148148148
house,128,89,18,0.202247191011,0.555555555556,8,0.0898876404494,10,0.112359550562
house,129,80,11,0.1375,0.636363636364,4,0.05,7,0.0875
house,130,75,15,0.2,0.8,3,0.04,12,0.16
house,131,76,14,0.184210526316,0.428571428571,8,0.105263157895,6,0.0789473684211
house,132,77,13,0.168831168831,0.615384615385,5,0.0649350649351,8,0.103896103896
house,133,91,18,0.197802197802,0.666666666667,6,0.0659340659341,12,0.131868131868
house,134,82,13,0.158536585366,0.384615384615,8,0.0975609756098,5,0.0609756097561
house,135,78,24,0.307692307692,0.541666666667,11,0.141025641026,13,0.166666666667
house,136,73,11,0.150684931507,0.545454545455,5,0.0684931506849,6,0.0821917808219
house,137,73,13,0.178082191781,0.692307692308,4,0.0547945205479,9,0.123287671233
house,138,70,20,0.285714285714,0.55,9,0.128571428571,11,0.157142857143
house,139,61,12,0.196721311475,0.583333333333,5,0.0819672131148,7,0.114754098361
house,140,73,19,0.260273972603,0.421052631579,11,0.150684931507,8,0.109589041096
house,141,72,17,0.236111111111,0.647058823529,6,0.0833333333333,11,0.152777777778
house,142,63,10,0.15873015873,0.6,4,0.0634920634921,6,0.0952380952381
house,143,65,9,0.138461538462,0.555555555556,4,0.0615384615385,5,0.0769230769231
house,144,67,17,0.253731343284,0.588235294118,7,0.10447761194,10,0.149253731343
house,145,64,14,0.21875,0.428571428571,8,0.125,6,0.09375
house,146,74,11,0.148648648649,0.545454545455,5,0.0675675675676,6,0.0810810810811
house,147,49,8,0.163265306122,0.75,2,0.0408163265306,6,0.122448979592
house,148,64,11,0.171875,0.636363636364,4,0.0625,7,0.109375
house,149,57,11,0.19298245614,0.545454545455,5,0.0877192982456,6,0.105263157895
house,150,58,10,0.172413793103,0.5,5,0.0862068965517,5,0.0862068965517
house,151,65,11,0.169230769231,0.727272727273,3,0.0461538461538,8,0.123076923077
house,152,54,6,0.111111111111,1.0,0,0.0,6,0.111111111111
house,153,44,7,0.159090909091,0.428571428571,4,0.0909090909091,3,0.0681818181818
house,154,44,15,0.340909090909,0.6,6,0.136363636364,9,0.204545454545
house,155,53,10,0.188679245283,0.7,3,0.0566037735849,7,0.132075471698
house,156,48,6,0.125,0.5,3,0.0625,3,0.0625
house,157,52,9,0.173076923077,0.555555555556,4,0.0769230769231,5,0.0961538461538
house,158,48,11,0.229166666667,0.727272727273,3,0.0625,8,0.166666666667
house,159,50,11,0.22,0.727272727273,3,0.06,8,0.16
house,160,39,7,0.179487179487,0.428571428571,4,0.102564102564,3,0.0769230769231
house,161,39,8,0.205128205128,0.5,4,0.102564102564,4,0.102564102564
house,162,41,10,0.243902439024,0.7,3,0.0731707317073,7,0.170731707317
house,163,47,9,0.191489361702,0.444444444444,5,0.106382978723,4,0.0851063829787
house,164,47,12,0.255319148936,0.583333333333,5,0.106382978723,7,0.148936170213
house,165,43,7,0.162790697674,1.0,0,0.0,7,0.162790697674
house,166,26,3,0.115384615385,0.666666666667,1,0.0384615384615,2,0.0769230769231
house,167,36,3,0.0833333333333,0.333333333333,2,0.0555555555556,1,0.0277777777778
house,168,37,6,0.162162162162,0.833333333333,1,0.027027027027,5,0.135135135135
house,169,33,5,0.151515151515,0.6,2,0.0606060606061,3,0.0909090909091
house,170,27,8,0.296296296296,1.0,0,0.0,8,0.296296296296
house,171,40,9,0.225,0.444444444444,5,0.125,4,0.1
house,172,41,4,0.0975609756098,0.5,2,0.0487804878049,2,0.0487804878049
house,173,38,9,0.236842105263,0.222222222222,7,0.184210526316,2,0.0526315789474
house,174,25,4,0.16,0.5,2,0.08,2,0.08
house,175,31,4,0.129032258065,0.5,2,0.0645161290323,2,0.0645161290323
house,176,44,6,0.136363636364,0.0,6,0.136363636364,0,0.0
house,177,34,7,0.205882352941,0.571428571429,3,0.0882352941176,4,0.117647058824
house,178,22,4,0.181818181818,0.5,2,0.0909090909091,2,0.0909090909091
house,179,35,4,0.114285714286,0.75,1,0.0285714285714,3,0.0857142857143
house,180,27,8,0.296296296296,0.5,4,0.148148148148,4,0.148148148148
house,181,23,5,0.217391304348,0.6,2,0.0869565217391,3,0.130434782609
house,182,33,5,0.151515151515,0.6,2,0.0606060606061,3,0.0909090909091
house,183,39,10,0.25641025641,0.3,7,0.179487179487,3,0.0769230769231
house,184,32,3,0.09375,0.666666666667,1,0.03125,2,0.0625
house,185,24,3,0.125,0.333333333333,2,0.0833333333333,1,0.0416666666667
house,186,27,7,0.259259259259,0.285714285714,5,0.185185185185,2,0.0740740740741
house,187,28,4,0.142857142857,0.75,1,0.0357142857143,3,0.107142857143
house,188,21,1,0.047619047619,0.0,1,0.047619047619,0,0.0
house,189,26,2,0.0769230769231,0.5,1,0.0384615384615,1,0.0384615384615
house,190,24,8,0.333333333333,0.625,3,0.125,5,0.208333333333
house,191,25,3,0.12,0.333333333333,2,0.08,1,0.04
house,192,23,3,0.130434782609,0.666666666667,1,0.0434782608696,2,0.0869565217391
house,193,28,5,0.178571428571,0.6,2,0.0714285714286,3,0.107142857143
house,194,20,4,0.2,0.5,2,0.1,2,0.1
house,195,31,8,0.258064516129,0.875,1,0.0322580645161,7,0.225806451613
house,196,22,4,0.181818181818,0.75,1,0.0454545454545,3,0.136363636364
house,197,21,3,0.142857142857,0.666666666667,1,0.047619047619,2,0.0952380952381
house,198,15,4,0.266666666667,0.75,1,0.0666666666667,3,0.2
house,199,19,3,0.157894736842,0.666666666667,1,0.0526315789474,2,0.105263157895
house,200,23,6,0.260869565217,0.5,3,0.130434782609,3,0.130434782609
house,201,22,4,0.181818181818,0.75,1,0.0454545454545,3,0.136363636364
house,202,18,3,0.166666666667,0.333333333333,2,0.111111111111,1,0.0555555555556
house,203,20,3,0.15,1.0,0,0.0,3,0.15
house,204,16,4,0.25,0.5,2,0.125,2,0.125
house,205,22,3,0.136363636364,0.666666666667,1,0.0454545454545,2,0.0909090909091
house,206,29,5,0.172413793103,0.4,3,0.103448275862,2,0.0689655172414
house,207,19,5,0.263157894737,0.8,1,0.0526315789474,4,0.210526315789
house,208,24,5,0.208333333333,0.8,1,0.0416666666667,4,0.166666666667
house,209,15,2,0.133333333333,0.0,2,0.133333333333,0,0.0
house,210,20,1,0.05,1.0,0,0.0,1,0.05
house,211,26,6,0.230769230769,0.833333333333,1,0.0384615384615,5,0.192307692308
house,212,18,5,0.277777777778,0.4,3,0.166666666667,2,0.111111111111
house,213,23,1,0.0434782608696,0.0,1,0.0434782608696,0,0.0
house,214,25,1,0.04,1.0,0,0.0,1,0.04
house,215,21,2,0.0952380952381,0.0,2,0.0952380952381,0,0.0
house,216,13,1,0.0769230769231,1.0,0,0.0,1,0.0769230769231
house,217,19,1,0.0526315789474,0.0,1,0.0526315789474,0,0.0
house,218,20,4,0.2,0.5,2,0.1,2,0.1
house,219,16,1,0.0625,1.0,0,0.0,1,0.0625
house,220,12,1,0.0833333333333,1.0,0,0.0,1,0.0833333333333
house,221,26,8,0.307692307692,0.75,2,0.0769230769231,6,0.230769230769
house,222,15,0,0.0,NULL,0,0.0,0,0.0
house,223,11,2,0.181818181818,0.0,2,0.181818181818,0,0.0
house,224,14,2,0.142857142857,0.5,1,0.0714285714286,1,0.0714285714286
house,225,17,5,0.294117647059,0.8,1,0.0588235294118,4,0.235294117647
house,226,11,1,0.0909090909091,0.0,1,0.0909090909091,0,0.0
house,227,15,4,0.266666666667,0.25,3,0.2,1,0.0666666666667
house,228,14,3,0.214285714286,0.666666666667,1,0.0714285714286,2,0.142857142857
house,229,15,3,0.2,0.666666666667,1,0.0666666666667,2,0.133333333333
house,230,8,2,0.25,0.5,1,0.125,1,0.125
house,231,19,3,0.157894736842,0.666666666667,1,0.0526315789474,2,0.105263157895
house,232,11,0,0.0,NULL,0,0.0,0,0.0
house,233,8,2,0.25,0.5,1,0.125,1,0.125
house,234,13,3,0.230769230769,0.333333333333,2,0.153846153846,1,0.0769230769231
house,235,8,3,0.375,0.0,3,0.375,0,0.0
house,236,12,2,0.166666666667,1.0,0,0.0,2,0.166666666667
house,237,10,0,0.0,NULL,0,0.0,0,0.0
house,238,18,2,0.111111111111,0.0,2,0.111111111111,0,0.0
house,239,8,0,0.0,NULL,0,0.0,0,0.0
house,240,7,0,0.0,NULL,0,0.0,0,0.0
house,241,15,3,0.2,0.666666666667,1,0.0666666666667,2,0.133333333333
house,242,17,4,0.235294117647,0.75,1,0.0588235294118,3,0.176470588235
house,243,10,1,0.1,0.0,1,0.1,0,0.0
house,244,9,2,0.222222222222,1.0,0,0.0,2,0.222222222222
house,245,15,2,0.133333333333,0.0,2,0.133333333333,0,0.0
house,246,12,2,0.166666666667,0.5,1,0.0833333333333,1,0.0833333333333
house,247,11,1,0.0909090909091,1.0,0,0.0,1,0.0909090909091
house,248,8,1,0.125,1.0,0,0.0,1,0.125
house,249,15,3,0.2,0.333333333333,2,0.133333333333,1,0.0666666666667
house,250,7,2,0.285714285714,0.5,1,0.142857142857,1,0.142857142857
house,251,9,3,0.333333333333,1.0,0,0.0,3,0.333333333333
house,252,11,3,0.272727272727,0.666666666667,1,0.0909090909091,2,0.181818181818
house,253,13,5,0.384615384615,0.4,3,0.230769230769,2,0.153846153846
house,254,14,4,0.285714285714,0.5,2,0.142857142857,2,0.142857142857
house,255,10,1,0.1,1.0,0,0.0,1,0.1
house,256,8,2,0.25,1.0,0,0.0,2,0.25
house,257,13,1,0.0769230769231,0.0,1,0.0769230769231,0,0.0
house,258,8,2,0.25,1.0,0,0.0,2,0.25
house,259,10,3,0.3,0.333333333333,2,0.2,1,0.1
house,260,6,0,0.0,NULL,0,0.0,0,0.0
house,261,5,1,0.2,0.0,1,0.2,0,0.0
house,262,8,2,0.25,0.5,1,0.125,1,0.125
house,263,7,1,0.142857142857,1.0,0,0.0,1,0.142857142857
house,264,9,1,0.111111111111,1.0,0,0.0,1,0.111111111111
house,265,6,0,0.0,NULL,0,0.0,0,0.0
house,266,13,3,0.230769230769,1.0,0,0.0,3,0.230769230769
house,267,14,4,0.285714285714,0.75,1,0.0714285714286,3,0.214285714286
house,268,12,1,0.0833333333333,0.0,1,0.0833333333333,0,0.0
house,269,10,4,0.4,0.75,1,0.1,3,0.3
house,270,12,3,0.25,0.333333333333,2,0.166666666667,1,0.0833333333333
house,271,8,2,0.25,0.5,1,0.125,1,0.125
house,272,7,0,0.0,NULL,0,0.0,0,0.0
house,273,8,1,0.125,1.0,0,0.0,1,0.125
house,274,8,3,0.375,0.666666666667,1,0.125,2,0.25
house,275,9,1,0.111111111111,1.0,0,0.0,1,0.111111111111
house,276,14,1,0.0714285714286,0.0,1,0.0714285714286,0,0.0
house,277,4,0,0.0,NULL,0,0.0,0,0.0
house,278,7,0,0.0,NULL,0,0.0,0,0.0
house,279,10,0,0.0,NULL,0,0.0,0,0.0
house,280,5,0,0.0,NULL,0,0.0,0,0.0
house,281,2,0,0.0,NULL,0,0.0,0,0.0
house,282,10,3,0.3,0.666666666667,1,0.1,2,0.2
house,283,6,0,0.0,NULL,0,0.0,0,0.0
house,284,3,0,0.0,NULL,0,0.0,0,0.0
house,285,7,0,0.0,NULL,0,0.0,0,0.0
house,286,13,1,0.0769230769231,1.0,0,0.0,1,0.0769230769231
house,287,8,2,0.25,1.0,0,0.0,2,0.25
house,288,5,1,0.2,1.0,0,0.0,1,0.2
house,289,12,1,0.0833333333333,1.0,0,0.0,1,0.0833333333333
house,290,11,0,0.0,NULL,0,0.0,0,0.0
house,291,7,0,0.0,NULL,0,0.0,0,0.0
house,292,5,0,0.0,NULL,0,0.0,0,0.0
house,293,5,0,0.0,NULL,0,0.0,0,0.0
house,294,8,3,0.375,1.0,0,0.0,3,0.375
house,295,5,0,0.0,NULL,0,0.0,0,0.0
house,296,1,0,0.0,NULL,0,0.0,0,0.0
house,297,2,1,0.5,0.0,1,0.5,0,0.0
house,298,6,1,0.166666666667,0.0,1,0.166666666667,0,0.0
house,299,7,1,0.142857142857,1.0,0,0.0,1,0.142857142857
house,300,4,1,0.25,0.0,1,0.25,0,0.0
house,301,9,2,0.222222222222,1.0,0,0.0,2,0.222222222222
house,302,7,1,0.142857142857,1.0,0,0.0,1,0.142857142857
house,303,8,2,0.25,0.5,1,0.125,1,0.125
house,304,4,1,0.25,1.0,0,0.0,1,0.25
house,305,5,0,0.0,NULL,0,0.0,0,0.0
house,306,4,0,0.0,NULL,0,0.0,0,0.0
house,307,2,0,0.0,NULL,0,0.0,0,0.0
house,308,5,0,0.0,NULL,0,0.0,0,0.0
house,309,3,0,0.0,NULL,0,0.0,0,0.0
house,310,6,0,0.0,NULL,0,0.0,0,0.0
house,311,5,0,0.0,NULL,0,0.0,0,0.0
house,312,2,2,1.0,1.0,0,0.0,2,1.0
house,313,8,1,0.125,0.0,1,0.125,0,0.0
house,314,5,0,0.0,NULL,0,0.0,0,0.0
house,315,6,0,0.0,NULL,0,0.0,0,0.0
house,316,6,1,0.166666666667,0.0,1,0.166666666667,0,0.0
house,317,7,1,0.142857142857,1.0,0,0.0,1,0.142857142857
house,318,8,0,0.0,NULL,0,0.0,0,0.0
house,319,7,2,0.285714285714,0.5,1,0.142857142857,1,0.142857142857
house,320,3,0,0.0,NULL,0,0.0,0,0.0
house,321,7,1,0.142857142857,0.0,1,0.142857142857,0,0.0
house,322,4,0,0.0,NULL,0,0.0,0,0.0
house,323,6,0,0.0,NULL,0,0.0,0,0.0
house,324,7,0,0.0,NULL,0,0.0,0,0.0
house,325,3,0,0.0,NULL,0,0.0,0,0.0
house,326,4,0,0.0,NULL,0,0.0,0,0.0
house,327,3,2,0.666666666667,0.5,1,0.333333333333,1,0.333333333333
house,328,3,1,0.333333333333,0.0,1,0.333333333333,0,0.0
house,329,6,1,0.166666666667,0.0,1,0.166666666667,0,0.0
house,332,3,1,0.333333333333,0.0,1,0.333333333333,0,0.0
house,333,6,2,0.333333333333,0.5,1,0.166666666667,1,0.166666666667
house,334,2,0,0.0,NULL,0,0.0,0,0.0
house,335,6,3,0.5,1.0,0,0.0,3,0.5
house,336,3,0,0.0,NULL,0,0.0,0,0.0
house,337,3,0,0.0,NULL,0,0.0,0,0.0
house,338,5,2,0.4,1.0,0,0.0,2,0.4
house,339,4,1,0.25,1.0,0,0.0,1,0.25
house,340,5,0,0.0,NULL,0,0.0,0,0.0
house,341,8,1,0.125,0.0,1,0.125,0,0.0
house,342,8,0,0.0,NULL,0,0.0,0,0.0
house,343,2,0,0.0,NULL,0,0.0,0,0.0
house,344,3,0,0.0,NULL,0,0.0,0,0.0
house,345,4,0,0.0,NULL,0,0.0,0,0.0
house,346,4,1,0.25,0.0,1,0.25,0,0.0
house,347,4,1,0.25,1.0,0,0.0,1,0.25
house,348,8,2,0.25,0.5,1,0.125,1,0.125
house,349,3,0,0.0,NULL,0,0.0,0,0.0
house,350,5,2,0.4,1.0,0,0.0,2,0.4
house,351,5,1,0.2,0.0,1,0.2,0,0.0
house,352,5,1,0.2,1.0,0,0.0,1,0.2
house,353,5,0,0.0,NULL,0,0.0,0,0.0
house,354,4,1,0.25,1.0,0,0.0,1,0.25
house,355,2,0,0.0,NULL,0,0.0,0,0.0
house,356,3,0,0.0,NULL,0,0.0,0,0.0
house,357,7,2,0.285714285714,1.0,0,0.0,2,0.285714285714
house,358,7,1,0.142857142857,0.0,1,0.142857142857,0,0.0
house,359,4,2,0.5,0.5,1,0.25,1,0.25
house,360,7,1,0.142857142857,0.0,1,0.142857142857,0,0.0
house,361,2,0,0.0,NULL,0,0.0,0,0.0
house,362,4,2,0.5,0.5,1,0.25,1,0.25
house,363,3,1,0.333333333333,0.0,1,0.333333333333,0,0.0
house,365,5,1,0.2,0.0,1,0.2,0,0.0
house,366,3,1,0.333333333333,0.0,1,0.333333333333,0,0.0
house,367,1,0,0.0,NULL,0,0.0,0,0.0
house,368,3,2,0.666666666667,1.0,0,0.0,2,0.666666666667
house,369,2,0,0.0,NULL,0,0.0,0,0.0
house,371,5,1,0.2,1.0,0,0.0,1,0.2
house,372,4,0,0.0,NULL,0,0.0,0,0.0
house,374,4,1,0.25,1.0,0,0.0,1,0.25
house,375,2,1,0.5,0.0,1,0.5,0,0.0
house,376,4,0,0.0,NULL,0,0.0,0,0.0
house,377,4,0,0.0,NULL,0,0.0,0,0.0
house,378,10,0,0.0,NULL,0,0.0,0,0.0
house,379,6,0,0.0,NULL,0,0.0,0,0.0
house,380,2,0,0.0,NULL,0,0.0,0,0.0
house,381,4,1,0.25,1.0,0,0.0,1,0.25
house,382,2,0,0.0,NULL,0,0.0,0,0.0
house,383,5,0,0.0,NULL,0,0.0,0,0.0
house,384,1,0,0.0,NULL,0,0.0,0,0.0
house,385,3,0,0.0,NULL,0,0.0,0,0.0
house,386,1,1,1.0,1.0,0,0.0,1,1.0
house,387,2,0,0.0,NULL,0,0.0,0,0.0
house,388,2,0,0.0,NULL,0,0.0,0,0.0
house,390,2,1,0.5,1.0,0,0.0,1,0.5
house,391,4,2,0.5,0.5,1,0.25,1,0.25
house,393,5,0,0.0,NULL,0,0.0,0,0.0
house,394,2,0,0.0,NULL,0,0.0,0,0.0
house,395,2,2,1.0,0.5,1,0.5,1,0.5
house,396,1,0,0.0,NULL,0,0.0,0,0.0
house,397,1,0,0.0,NULL,0,0.0,0,0.0
house,399,7,1,0.142857142857,1.0,0,0.0,1,0.142857142857
house,400,1,0,0.0,NULL,0,0.0,0,0.0
house,401,3,0,0.0,NULL,0,0.0,0,0.0
house,402,3,1,0.333333333333,1.0,0,0.0,1,0.333333333333
house,403,1,0,0.0,NULL,0,0.0,0,0.0
house,404,5,1,0.2,1.0,0,0.0,1,0.2
house,405,4,0,0.0,NULL,0,0.0,0,0.0
house,406,4,0,0.0,NULL,0,0.0,0,0.0
house,407,2,0,0.0,NULL,0,0.0,0,0.0
house,408,5,0,0.0,NULL,0,0.0,0,0.0
house,409,6,2,0.333333333333,0.5,1,0.166666666667,1,0.166666666667
house,410,2,0,0.0,NULL,0,0.0,0,0.0
house,411,1,0,0.0,NULL,0,0.0,0,0.0
house,412,2,0,0.0,NULL,0,0.0,0,0.0
house,413,3,1,0.333333333333,0.0,1,0.333333333333,0,0.0
house,414,2,0,0.0,NULL,0,0.0,0,0.0
house,415,1,0,0.0,NULL,0,0.0,0,0.0
house,417,1,0,0.0,NULL,0,0.0,0,0.0
house,418,3,1,0.333333333333,0.0,1,0.333333333333,0,0.0
house,419,1,0,0.0,NULL,0,0.0,0,0.0
house,420,4,1,0.25,0.0,1,0.25,0,0.0
house,421,2,0,0.0,NULL,0,0.0,0,0.0
house,422,3,1,0.333333333333,0.0,1,0.333333333333,0,0.0
house,423,4,1,0.25,0.0,1,0.25,0,0.0
house,424,1,0,0.0,NULL,0,0.0,0,0.0
house,425,3,0,0.0,NULL,0,0.0,0,0.0
house,426,1,0,0.0,NULL,0,0.0,0,0.0
house,427,1,0,0.0,NULL,0,0.0,0,0.0
house,429,2,0,0.0,NULL,0,0.0,0,0.0
house,430,2,1,0.5,1.0,0,0.0,1,0.5
house,431,6,0,0.0,NULL,0,0.0,0,0.0
house,432,1,0,0.0,NULL,0,0.0,0,0.0
house,433,1,0,0.0,NULL,0,0.0,0,0.0
house,434,1,1,1.0,1.0,0,0.0,1,1.0
house,435,2,0,0.0,NULL,0,0.0,0,0.0
house,436,3,0,0.0,NULL,0,0.0,0,0.0
house,437,3,1,0.333333333333,1.0,0,0.0,1,0.333333333333
house,438,1,0,0.0,NULL,0,0.0,0,0.0
house,439,3,0,0.0,NULL,0,0.0,0,0.0
house,440,1,1,1.0,0.0,1,1.0,0,0.0
house,441,6,0,0.0,NULL,0,0.0,0,0.0
house,442,2,0,0.0,NULL,0,0.0,0,0.0
house,443,2,1,0.5,0.0,1,0.5,0,0.0
house,444,3,0,0.0,NULL,0,0.0,0,0.0
house,446,3,2,0.666666666667,0.0,2,0.666666666667,0,0.0
house,447,2,0,0.0,NULL,0,0.0,0,0.0
house,448,3,0,0.0,NULL,0,0.0,0,0.0
house,449,1,0,0.0,NULL,0,0.0,0,0.0
house,450,1,0,0.0,NULL,0,0.0,0,0.0
house,451,1,1,1.0,0.0,1,1.0,0,0.0
house,453,2,0,0.0,NULL,0,0.0,0,0.0
house,454,4,1,0.25,0.0,1,0.25,0,0.0
house,456,4,0,0.0,NULL,0,0.0,0,0.0
house,457,1,0,0.0,NULL,0,0.0,0,0.0
house,458,1,0,0.0,NULL,0,0.0,0,0.0
house,459,2,0,0.0,NULL,0,0.0,0,0.0
house,462,1,0,0.0,NULL,0,0.0,0,0.0
house,463,1,0,0.0,NULL,0,0.0,0,0.0
house,464,2,0,0.0,NULL,0,0.0,0,0.0
house,465,2,0,0.0,NULL,0,0.0,0,0.0
house,467,2,0,0.0,NULL,0,0.0,0,0.0
house,469,1,0,0.0,NULL,0,0.0,0,0.0
house,470,4,2,0.5,0.5,1,0.25,1,0.25
house,471,2,0,0.0,NULL,0,0.0,0,0.0
house,473,3,0,0.0,NULL,0,0.0,0,0.0
house,474,1,0,0.0,NULL,0,0.0,0,0.0
house,475,3,0,0.0,NULL,0,0.0,0,0.0
house,477,1,0,0.0,NULL,0,0.0,0,0.0
house,478,1,0,0.0,NULL,0,0.0,0,0.0
house,479,2,0,0.0,NULL,0,0.0,0,0.0
house,480,2,0,0.0,NULL,0,0.0,0,0.0
house,481,2,0,0.0,NULL,0,0.0,0,0.0
house,483,3,0,0.0,NULL,0,0.0,0,0.0
house,484,2,0,0.0,NULL,0,0.0,0,0.0
house,485,1,0,0.0,NULL,0,0.0,0,0.0
house,487,1,0,0.0,NULL,0,0.0,0,0.0
house,488,4,0,0.0,NULL,0,0.0,0,0.0
house,492,2,0,0.0,NULL,0,0.0,0,0.0
house,493,1,0,0.0,NULL,0,0.0,0,0.0
house,495,3,1,0.333333333333,0.0,1,0.333333333333,0,0.0
house,496,1,0,0.0,NULL,0,0.0,0,0.0
house,497,2,0,0.0,NULL,0,0.0,0,0.0
house,498,1,0,0.0,NULL,0,0.0,0,0.0
house,500,1,0,0.0,NULL,0,0.0,0,0.0
house,501,1,0,0.0,NULL,0,0.0,0,0.0
house,502,1,0,0.0,NULL,0,0.0,0,0.0
house,503,3,2,0.666666666667,0.5,1,0.333333333333,1,0.333333333333
house,504,2,1,0.5,1.0,0,0.0,1,0.5
house,505,1,0,0.0,NULL,0,0.0,0,0.0
house,506,1,0,0.0,NULL,0,0.0,0,0.0
house,507,1,0,0.0,NULL,0,0.0,0,0.0
house,511,3,0,0.0,NULL,0,0.0,0,0.0
house,512,2,0,0.0,NULL,0,0.0,0,0.0
house,514,2,0,0.0,NULL,0,0.0,0,0.0
house,515,2,0,0.0,NULL,0,0.0,0,0.0
house,517,2,1,0.5,1.0,0,0.0,1,0.5
house,520,4,0,0.0,NULL,0,0.0,0,0.0
house,524,2,1,0.5,1.0,0,0.0,1,0.5
house,525,1,0,0.0,NULL,0,0.0,0,0.0
house,530,1,0,0.0,NULL,0,0.0,0,0.0
house,531,1,0,0.0,NULL,0,0.0,0,0.0
house,532,2,1,0.5,1.0,0,0.0,1,0.5
house,534,1,0,0.0,NULL,0,0.0,0,0.0
house,535,1,0,0.0,NULL,0,0.0,0,0.0
house,536,2,0,0.0,NULL,0,0.0,0,0.0
house,537,2,0,0.0,NULL,0,0.0,0,0.0
house,538,1,0,0.0,NULL,0,0.0,0,0.0
house,540,1,0,0.0,NULL,0,0.0,0,0.0
house,541,2,0,0.0,NULL,0,0.0,0,0.0
house,542,1,0,0.0,NULL,0,0.0,0,0.0
house,543,3,0,0.0,NULL,0,0.0,0,0.0
house,544,2,0,0.0,NULL,0,0.0,0,0.0
house,545,1,0,0.0,NULL,0,0.0,0,0.0
house,546,2,0,0.0,NULL,0,0.0,0,0.0
house,547,1,0,0.0,NULL,0,0.0,0,0.0
house,552,2,1,0.5,0.0,1,0.5,0,0.0
house,553,2,1,0.5,0.0,1,0.5,0,0.0
house,554,1,0,0.0,NULL,0,0.0,0,0.0
house,555,2,0,0.0,NULL,0,0.0,0,0.0
house,556,1,0,0.0,NULL,0,0.0,0,0.0
house,557,1,0,0.0,NULL,0,0.0,0,0.0
house,558,1,0,0.0,NULL,0,0.0,0,0.0
house,559,1,0,0.0,NULL,0,0.0,0,0.0
house,561,1,0,0.0,NULL,0,0.0,0,0.0
house,562,3,0,0.0,NULL,0,0.0,0,0.0
house,563,2,0,0.0,NULL,0,0.0,0,0.0
house,565,1,0,0.0,NULL,0,0.0,0,0.0
house,567,1,1,1.0,0.0,1,1.0,0,0.0
house,568,2,0,0.0,NULL,0,0.0,0,0.0
house,571,1,0,0.0,NULL,0,0.0,0,0.0
house,572,1,0,0.0,NULL,0,0.0,0,0.0
house,573,2,0,0.0,NULL,0,0.0,0,0.0
house,575,3,0,0.0,NULL,0,0.0,0,0.0
house,577,2,0,0.0,NULL,0,0.0,0,0.0
house,578,1,0,0.0,NULL,0,0.0,0,0.0
house,579,1,0,0.0,NULL,0,0.0,0,0.0
house,580,1,0,0.0,NULL,0,0.0,0,0.0
house,581,1,0,0.0,NULL,0,0.0,0,0.0
house,582,1,0,0.0,NULL,0,0.0,0,0.0
house,583,1,0,0.0,NULL,0,0.0,0,0.0
house,584,1,1,1.0,0.0,1,1.0,0,0.0
house,585,1,1,1.0,0.0,1,1.0,0,0.0
house,587,1,1,1.0,0.0,1,1.0,0,0.0
house,588,1,0,0.0,NULL,0,0.0,0,0.0
house,589,1,0,0.0,NULL,0,0.0,0,0.0
house,590,1,0,0.0,NULL,0,0.0,0,0.0
house,594,1,0,0.0,NULL,0,0.0,0,0.0
house,596,1,1,1.0,1.0,0,0.0,1,1.0
house,598,1,1,1.0,0.0,1,1.0,0,0.0
house,599,1,0,0.0,NULL,0,0.0,0,0.0
house,600,3,1,0.333333333333,1.0,0,0.0,1,0.333333333333
house,602,1,0,0.0,NULL,0,0.0,0,0.0
house,603,1,0,0.0,NULL,0,0.0,0,0.0
house,604,2,0,0.0,NULL,0,0.0,0,0.0
house,607,1,0,0.0,NULL,0,0.0,0,0.0
house,608,2,0,0.0,NULL,0,0.0,0,0.0
house,610,2,0,0.0,NULL,0,0.0,0,0.0
house,615,2,0,0.0,NULL,0,0.0,0,0.0
house,616,1,0,0.0,NULL,0,0.0,0,0.0
house,617,2,0,0.0,NULL,0,0.0,0,0.0
house,620,1,0,0.0,NULL,0,0.0,0,0.0
house,630,1,0,0.0,NULL,0,0.0,0,0.0
house,631,1,0,0.0,NULL,0,0.0,0,0.0
house,632,2,0,0.0,NULL,0,0.0,0,0.0
house,633,1,0,0.0,NULL,0,0.0,0,0.0
house,634,2,0,0.0,NULL,0,0.0,0,0.0
house,635,1,0,0.0,NULL,0,0.0,0,0.0
house,638,1,0,0.0,NULL,0,0.0,0,0.0
house,639,1,0,0.0,NULL,0,0.0,0,0.0
house,640,1,0,0.0,NULL,0,0.0,0,0.0
house,641,3,1,0.333333333333,0.0,1,0.333333333333,0,0.0
house,644,1,0,0.0,NULL,0,0.0,0,0.0
house,646,1,0,0.0,NULL,0,0.0,0,0.0
house,649,2,0,0.0,NULL,0,0.0,0,0.0
house,651,1,0,0.0,NULL,0,0.0,0,0.0
house,652,2,0,0.0,NULL,0,0.0,0,0.0
house,653,3,0,0.0,NULL,0,0.0,0,0.0
house,658,1,0,0.0,NULL,0,0.0,0,0.0
house,663,1,0,0.0,NULL,0,0.0,0,0.0
house,665,1,0,0.0,NULL,0,0.0,0,0.0
house,668,2,0,0.0,NULL,0,0.0,0,0.0
house,670,1,0,0.0,NULL,0,0.0,0,0.0
house,675,1,0,0.0,NULL,0,0.0,0,0.0
house,677,1,0,0.0,NULL,0,0.0,0,0.0
house,678,1,0,0.0,NULL,0,0.0,0,0.0
house,679,1,0,0.0,NULL,0,0.0,0,0.0
house,680,2,0,0.0,NULL,0,0.0,0,0.0
house,682,1,0,0.0,NULL,0,0.0,0,0.0
house,683,1,0,0.0,NULL,0,0.0,0,0.0
house,684,1,0,0.0,NULL,0,0.0,0,0.0
house,687,1,0,0.0,NULL,0,0.0,0,0.0
house,688,1,0,0.0,NULL,0,0.0,0,0.0
house,694,1,1,1.0,1.0,0,0.0,1,1.0
house,695,1,0,0.0,NULL,0,0.0,0,0.0
house,696,1,0,0.0,NULL,0,0.0,0,0.0
house,697,1,0,0.0,NULL,0,0.0,0,0.0
house,702,1,0,0.0,NULL,0,0.0,0,0.0
house,703,2,0,0.0,NULL,0,0.0,0,0.0
house,704,2,0,0.0,NULL,0,0.0,0,0.0
house,706,1,0,0.0,NULL,0,0.0,0,0.0
house,709,1,0,0.0,NULL,0,0.0,0,0.0
house,714,1,0,0.0,NULL,0,0.0,0,0.0
house,715,2,1,0.5,0.0,1,0.5,0,0.0
house,717,1,0,0.0,NULL,0,0.0,0,0.0
house,718,1,0,0.0,NULL,0,0.0,0,0.0
house,719,1,0,0.0,NULL,0,0.0,0,0.0
house,720,1,0,0.0,NULL,0,0.0,0,0.0
house,724,1,0,0.0,NULL,0,0.0,0,0.0
house,726,2,0,0.0,NULL,0,0.0,0,0.0
house,730,2,0,0.0,NULL,0,0.0,0,0.0
house,731,1,0,0.0,NULL,0,0.0,0,0.0
house,733,2,0,0.0,NULL,0,0.0,0,0.0
house,735,2,0,0.0,NULL,0,0.0,0,0.0
house,742,1,1,1.0,1.0,0,0.0,1,1.0
house,745,3,0,0.0,NULL,0,0.0,0,0.0
house,746,1,0,0.0,NULL,0,0.0,0,0.0
house,752,1,0,0.0,NULL,0,0.0,0,0.0
house,754,1,0,0.0,NULL,0,0.0,0,0.0
house,757,1,0,0.0,NULL,0,0.0,0,0.0
house,758,1,0,0.0,NULL,0,0.0,0,0.0
house,760,1,0,0.0,NULL,0,0.0,0,0.0
house,762,1,0,0.0,NULL,0,0.0,0,0.0
house,766,1,0,0.0,NULL,0,0.0,0,0.0
house,767,1,0,0.0,NULL,0,0.0,0,0.0
house,770,1,0,0.0,NULL,0,0.0,0,0.0
house,773,2,1,0.5,1.0,0,0.0,1,0.5
house,779,1,0,0.0,NULL,0,0.0,0,0.0
house,781,1,0,0.0,NULL,0,0.0,0,0.0
house,783,1,0,0.0,NULL,0,0.0,0,0.0
house,786,1,0,0.0,NULL,0,0.0,0,0.0
house,794,2,0,0.0,NULL,0,0.0,0,0.0
house,795,1,0,0.0,NULL,0,0.0,0,0.0
house,797,1,0,0.0,NULL,0,0.0,0,0.0
house,806,1,0,0.0,NULL,0,0.0,0,0.0
house,811,1,1,1.0,0.0,1,1.0,0,0.0
house,814,1,0,0.0,NULL,0,0.0,0,0.0
house,823,1,0,0.0,NULL,0,0.0,0,0.0
house,824,1,0,0.0,NULL,0,0.0,0,0.0
house,839,2,0,0.0,NULL,0,0.0,0,0.0
house,846,1,0,0.0,NULL,0,0.0,0,0.0
house,848,1,0,0.0,NULL,0,0.0,0,0.0
house,853,1,0,0.0,NULL,0,0.0,0,0.0
house,856,2,0,0.0,NULL,0,0.0,0,0.0
house,860,1,0,0.0,NULL,0,0.0,0,0.0
house,862,1,0,0.0,NULL,0,0.0,0,0.0
house,867,1,0,0.0,NULL,0,0.0,0,0.0
house,875,1,0,0.0,NULL,0,0.0,0,0.0
house,880,2,0,0.0,NULL,0,0.0,0,0.0
house,882,1,0,0.0,NULL,0,0.0,0,0.0
house,883,1,0,0.0,NULL,0,0.0,0,0.0
house,885,1,0,0.0,NULL,0,0.0,0,0.0
house,891,1,0,0.0,NULL,0,0.0,0,0.0
house,895,1,1,1.0,1.0,0,0.0,1,1.0
house,896,1,0,0.0,NULL,0,0.0,0,0.0
house,902,2,0,0.0,NULL,0,0.0,0,0.0
house,925,1,0,0.0,NULL,0,0.0,0,0.0
house,928,1,0,0.0,NULL,0,0.0,0,0.0
house,944,1,0,0.0,NULL,0,0.0,0,0.0
house,948,1,0,0.0,NULL,0,0.0,0,0.0
house,953,1,0,0.0,NULL,0,0.0,0,0.0
house,963,1,0,0.0,NULL,0,0.0,0,0.0
house,973,1,0,0.0,NULL,0,0.0,0,0.0
house,976,1,0,0.0,NULL,0,0.0,0,0.0
house,979,1,0,0.0,NULL,0,0.0,0,0.0
house,981,1,0,0.0,NULL,0,0.0,0,0.0
house,991,1,0,0.0,NULL,0,0.0,0,0.0
house,992,1,0,0.0,NULL,0,0.0,0,0.0
house,998,1,0,0.0,NULL,0,0.0,0,0.0
house,999,1,0,0.0,NULL,0,0.0,0,0.0
house,1000,1,0,0.0,NULL,0,0.0,0,0.0
house,1007,1,0,0.0,NULL,0,0.0,0,0.0
house,1020,1,0,0.0,NULL,0,0.0,0,0.0
house,1026,1,0,0.0,NULL,0,0.0,0,0.0
house,1029,1,0,0.0,NULL,0,0.0,0,0.0
house,1038,1,0,0.0,NULL,0,0.0,0,0.0
house,1040,1,0,0.0,NULL,0,0.0,0,0.0
house,1048,1,0,0.0,NULL,0,0.0,0,0.0
house,1055,1,0,0.0,NULL,0,0.0,0,0.0
house,1064,1,0,0.0,NULL,0,0.0,0,0.0
house,1086,1,0,0.0,NULL,0,0.0,0,0.0
house,1108,1,0,0.0,NULL,0,0.0,0,0.0
house,1109,1,0,0.0,NULL,0,0.0,0,0.0
house,1120,2,0,0.0,NULL,0,0.0,0,0.0
house,1122,2,1,0.5,1.0,0,0.0,1,0.5
house,1131,1,0,0.0,NULL,0,0.0,0,0.0
house,1136,1,0,0.0,NULL,0,0.0,0,0.0
house,1137,1,0,0.0,NULL,0,0.0,0,0.0
house,1140,1,0,0.0,NULL,0,0.0,0,0.0
house,1158,1,0,0.0,NULL,0,0.0,0,0.0
house,1174,1,0,0.0,NULL,0,0.0,0,0.0
house,1178,1,0,0.0,NULL,0,0.0,0,0.0
house,1210,1,0,0.0,NULL,0,0.0,0,0.0
house,1253,1,1,1.0,1.0,0,0.0,1,1.0
house,1282,1,0,0.0,NULL,0,0.0,0,0.0
house,1296,1,0,0.0,NULL,0,0.0,0,0.0
house,1299,1,0,0.0,NULL,0,0.0,0,0.0
house,1310,1,0,0.0,NULL,0,0.0,0,0.0
house,1317,1,0,0.0,NULL,0,0.0,0,0.0
house,1338,1,0,0.0,NULL,0,0.0,0,0.0
house,1364,1,0,0.0,NULL,0,0.0,0,0.0
house,1371,1,0,0.0,NULL,0,0.0,0,0.0
house,1385,1,0,0.0,NULL,0,0.0,0,0.0
house,1387,1,0,0.0,NULL,0,0.0,0,0.0
house,1405,1,0,0.0,NULL,0,0.0,0,0.0
house,1430,1,0,0.0,NULL,0,0.0,0,0.0
house,1451,1,0,0.0,NULL,0,0.0,0,0.0
house,1485,1,0,0.0,NULL,0,0.0,0,0.0
house,1493,1,0,0.0,NULL,0,0.0,0,0.0
house,1497,1,1,1.0,0.0,1,1.0,0,0.0
house,1500,1,0,0.0,NULL,0,0.0,0,0.0
house,1504,2,0,0.0,NULL,0,0.0,0,0.0
house,1516,1,0,0.0,NULL,0,0.0,0,0.0
house,1616,1,0,0.0,NULL,0,0.0,0,0.0
house,1622,1,0,0.0,NULL,0,0.0,0,0.0
house,1626,1,0,0.0,NULL,0,0.0,0,0.0
house,1643,1,0,0.0,NULL,0,0.0,0,0.0
house,1660,1,0,0.0,NULL,0,0.0,0,0.0
house,1713,1,0,0.0,NULL,0,0.0,0,0.0
house,1724,1,0,0.0,NULL,0,0.0,0,0.0
house,1779,1,0,0.0,NULL,0,0.0,0,0.0
house,1782,1,0,0.0,NULL,0,0.0,0,0.0
house,2044,1,0,0.0,NULL,0,0.0,0,0.0
house,2119,1,0,0.0,NULL,0,0.0,0,0.0
house,2175,1,0,0.0,NULL,0,0.0,0,0.0
house,2228,1,0,0.0,NULL,0,0.0,0,0.0
house,2232,1,1,1.0,1.0,0,0.0,1,1.0
house,2275,1,0,0.0,NULL,0,0.0,0,0.0
house,2309,1,0,0.0,NULL,0,0.0,0,0.0
house,2317,1,0,0.0,NULL,0,0.0,0,0.0
house,2541,1,0,0.0,NULL,0,0.0,0,0.0
house,2602,1,0,0.0,NULL,0,0.0,0,0.0
house,2747,1,1,1.0,1.0,0,0.0,1,1.0
house,2750,1,0,0.0,NULL,0,0.0,0,0.0
house,2830,1,0,0.0,NULL,0,0.0,0,0.0
house,2947,1,0,0.0,NULL,0,0.0,0,0.0
house,3256,1,1,1.0,1.0,0,0.0,1,1.0
house,3410,1,0,0.0,NULL,0,0.0,0,0.0
house,3896,1,0,0.0,NULL,0,0.0,0,0.0
house,4686,1,0,0.0,NULL,0,0.0,0,0.0
house,4918,1,0,0.0,NULL,0,0.0,0,0.0
house,6756,1,0,0.0,NULL,0,0.0,0,0.0
loan,0,7540734,638187,0.0846319469696,0.315402852142,436901,0.0579387895131,201286,0.0266931574566
loan,1,6339,1728,0.272598201609,0.491319444444,879,0.138665404638,849,0.133932796971
loan,2,3157,914,0.289515362686,0.528446389497,431,0.136522014571,483,0.152993348115
loan,3,745,258,0.346308724832,0.550387596899,116,0.155704697987,142,0.190604026846
loan,4,893,232,0.259798432251,0.534482758621,108,0.120940649496,124,0.138857782755
loan,5,210,69,0.328571428571,0.550724637681,31,0.147619047619,38,0.180952380952
loan,6,418,93,0.222488038278,0.623655913978,35,0.0837320574163,58,0.138755980861
loan,7,106,35,0.330188679245,0.685714285714,11,0.103773584906,24,0.22641509434
loan,8,260,50,0.192307692308,0.58,21,0.0807692307692,29,0.111538461538
loan,9,64,21,0.328125,0.571428571429,9,0.140625,12,0.1875
loan,10,163,35,0.21472392638,0.485714285714,18,0.110429447853,17,0.104294478528
loan,11,45,7,0.155555555556,0.714285714286,2,0.0444444444444,5,0.111111111111
loan,12,127,16,0.125984251969,0.5625,7,0.0551181102362,9,0.0708661417323
loan,13,27,5,0.185185185185,0.6,2,0.0740740740741,3,0.111111111111
loan,14,85,3,0.0352941176471,0.666666666667,1,0.0117647058824,2,0.0235294117647
loan,15,19,2,0.105263157895,0.5,1,0.0526315789474,1,0.0526315789474
loan,16,68,8,0.117647058824,0.625,3,0.0441176470588,5,0.0735294117647
loan,17,18,3,0.166666666667,0.333333333333,2,0.111111111111,1,0.0555555555556
loan,18,65,5,0.0769230769231,0.6,2,0.0307692307692,3,0.0461538461538
loan,19,25,1,0.04,1.0,0,0.0,1,0.04
loan,20,34,4,0.117647058824,0.5,2,0.0588235294118,2,0.0588235294118
loan,21,10,0,0.0,NULL,0,0.0,0,0.0
loan,22,28,1,0.0357142857143,0.0,1,0.0357142857143,0,0.0
loan,23,11,0,0.0,NULL,0,0.0,0,0.0
loan,24,27,2,0.0740740740741,1.0,0,0.0,2,0.0740740740741
loan,25,11,1,0.0909090909091,0.0,1,0.0909090909091,0,0.0
loan,26,29,4,0.137931034483,0.5,2,0.0689655172414,2,0.0689655172414
loan,27,9,0,0.0,NULL,0,0.0,0,0.0
loan,28,16,1,0.0625,0.0,1,0.0625,0,0.0
loan,29,15,1,0.0666666666667,1.0,0,0.0,1,0.0666666666667
loan,30,15,3,0.2,0.666666666667,1,0.0666666666667,2,0.133333333333
loan,31,8,2,0.25,0.0,2,0.25,0,0.0
loan,32,9,0,0.0,NULL,0,0.0,0,0.0
loan,33,4,0,0.0,NULL,0,0.0,0,0.0
loan,34,11,0,0.0,NULL,0,0.0,0,0.0
loan,35,7,0,0.0,NULL,0,0.0,0,0.0
loan,36,13,0,0.0,NULL,0,0.0,0,0.0
loan,37,3,0,0.0,NULL,0,0.0,0,0.0
loan,38,9,0,0.0,NULL,0,0.0,0,0.0
loan,39,4,0,0.0,NULL,0,0.0,0,0.0
loan,40,12,0,0.0,NULL,0,0.0,0,0.0
loan,41,7,0,0.0,NULL,0,0.0,0,0.0
loan,42,10,0,0.0,NULL,0,0.0,0,0.0
loan,43,3,0,0.0,NULL,0,0.0,0,0.0
loan,44,6,1,0.166666666667,0.0,1,0.166666666667,0,0.0
loan,45,7,1,0.142857142857,1.0,0,0.0,1,0.142857142857
loan,46,6,0,0.0,NULL,0,0.0,0,0.0
loan,47,6,1,0.166666666667,0.0,1,0.166666666667,0,0.0
loan,48,6,0,0.0,NULL,0,0.0,0,0.0
loan,49,2,0,0.0,NULL,0,0.0,0,0.0
loan,50,4,0,0.0,NULL,0,0.0,0,0.0
loan,51,1,0,0.0,NULL,0,0.0,0,0.0
loan,52,5,0,0.0,NULL,0,0.0,0,0.0
loan,53,2,0,0.0,NULL,0,0.0,0,0.0
loan,55,4,1,0.25,1.0,0,0.0,1,0.25
loan,56,1,0,0.0,NULL,0,0.0,0,0.0
loan,57,1,0,0.0,NULL,0,0.0,0,0.0
loan,58,4,1,0.25,0.0,1,0.25,0,0.0
loan,60,3,0,0.0,NULL,0,0.0,0,0.0
loan,62,2,0,0.0,NULL,0,0.0,0,0.0
loan,63,1,0,0.0,NULL,0,0.0,0,0.0
loan,64,4,0,0.0,NULL,0,0.0,0,0.0
loan,65,2,0,0.0,NULL,0,0.0,0,0.0
loan,66,3,0,0.0,NULL,0,0.0,0,0.0
loan,67,1,1,1.0,1.0,0,0.0,1,1.0
loan,72,1,0,0.0,NULL,0,0.0,0,0.0
loan,73,2,0,0.0,NULL,0,0.0,0,0.0
loan,74,1,0,0.0,NULL,0,0.0,0,0.0
loan,78,4,0,0.0,NULL,0,0.0,0,0.0
loan,79,3,0,0.0,NULL,0,0.0,0,0.0
loan,80,1,0,0.0,NULL,0,0.0,0,0.0
loan,81,2,0,0.0,NULL,0,0.0,0,0.0
loan,82,1,0,0.0,NULL,0,0.0,0,0.0
loan,83,1,0,0.0,NULL,0,0.0,0,0.0
loan,88,2,0,0.0,NULL,0,0.0,0,0.0
loan,89,2,0,0.0,NULL,0,0.0,0,0.0
loan,97,2,0,0.0,NULL,0,0.0,0,0.0
loan,98,1,0,0.0,NULL,0,0.0,0,0.0
loan,100,1,0,0.0,NULL,0,0.0,0,0.0
loan,102,1,0,0.0,NULL,0,0.0,0,0.0
loan,104,1,0,0.0,NULL,0,0.0,0,0.0
loan,105,1,0,0.0,NULL,0,0.0,0,0.0
loan,106,1,0,0.0,NULL,0,0.0,0,0.0
loan,107,1,0,0.0,NULL,0,0.0,0,0.0
loan,108,1,0,0.0,NULL,0,0.0,0,0.0
loan,114,1,0,0.0,NULL,0,0.0,0,0.0
loan,116,1,0,0.0,NULL,0,0.0,0,0.0
loan,118,1,0,0.0,NULL,0,0.0,0,0.0
loan,124,2,0,0.0,NULL,0,0.0,0,0.0
loan,135,1,0,0.0,NULL,0,0.0,0,0.0
loan,151,1,0,0.0,NULL,0,0.0,0,0.0
loan,159,1,0,0.0,NULL,0,0.0,0,0.0
loan,162,1,0,0.0,NULL,0,0.0,0,0.0
loan,165,1,0,0.0,NULL,0,0.0,0,0.0
loan,168,1,0,0.0,NULL,0,0.0,0,0.0
loan,174,1,0,0.0,NULL,0,0.0,0,0.0
loan,183,1,0,0.0,NULL,0,0.0,0,0.0
loan,211,1,0,0.0,NULL,0,0.0,0,0.0
loan,292,1,0,0.0,NULL,0,0.0,0,0.0
loan,304,1,0,0.0,NULL,0,0.0,0,0.0
loan,308,1,0,0.0,NULL,0,0.0,0,0.0
loan,344,1,0,0.0,NULL,0,0.0,0,0.0
loan,348,1,0,0.0,NULL,0,0.0,0,0.0
loan,676,1,0,0.0,NULL,0,0.0,0,0.0
luxuries,0,6184665,416243,0.0673024327106,0.273984187121,302199,0.0488626303931,114044,0.0184398023175
luxuries,1,560564,68270,0.121788056315,0.331829500513,45616,0.0813751864194,22654,0.0404128698953
luxuries,2,263724,41052,0.155662738317,0.356572152392,26414,0.100157740668,14638,0.0555049976491
luxuries,3,136779,23800,0.174003319223,0.386848739496,14593,0.106690354513,9207,0.0673129647095
luxuries,4,91951,17517,0.190503637807,0.393160929383,10630,0.115605050516,6887,0.0748985872911
luxuries,5,59655,12087,0.20261503646,0.406635227931,7172,0.120224624927,4915,0.082390411533
luxuries,6,45552,9584,0.210396909027,0.431865609349,5445,0.119533719705,4139,0.0908631893221
luxuries,7,32243,7256,0.225041094191,0.437706725469,4080,0.126539093757,3176,0.0985020004342
luxuries,8,26469,6102,0.23053383203,0.44968862668,3358,0.126865389701,2744,0.103668442329
luxuries,9,20320,4901,0.241190944882,0.463374821465,2630,0.129429133858,2271,0.111761811024
luxuries,10,16581,3984,0.24027501357,0.485441767068,2050,0.1236354864,1934,0.11663952717
luxuries,11,13518,3445,0.25484539133,0.467924528302,1833,0.135596981802,1612,0.119248409528
luxuries,12,11302,2870,0.25393735622,0.498606271777,1439,0.12732259777,1431,0.12661475845
luxuries,13,9194,2396,0.260604742223,0.502921535893,1191,0.129541005003,1205,0.13106373722
luxuries,14,7961,2015,0.253108905916,0.490322580645,1027,0.129003893983,988,0.124105011933
luxuries,15,6819,1784,0.261621938701,0.523542600897,850,0.124651708462,934,0.136970230239
luxuries,16,6003,1625,0.270697984341,0.520615384615,779,0.129768449109,846,0.140929535232
luxuries,17,5083,1419,0.279165846941,0.525017618041,674,0.132598858942,745,0.146566987999
luxuries,18,4721,1267,0.268375344207,0.514601420679,615,0.130269010803,652,0.138106333404
luxuries,19,3953,1072,0.271186440678,0.555037313433,477,0.120667847205,595,0.150518593473
luxuries,20,3583,986,0.275188389618,0.530425963489,463,0.129221322914,523,0.145967066704
luxuries,21,3249,895,0.275469375192,0.546368715084,406,0.124961526624,489,0.150507848569
luxuries,22,2864,782,0.273044692737,0.551150895141,351,0.122555865922,431,0.150488826816
luxuries,23,2603,728,0.279677295428,0.56043956044,320,0.122935074914,408,0.156742220515
luxuries,24,2346,643,0.274083546462,0.552099533437,288,0.122762148338,355,0.151321398124
luxuries,25,2044,556,0.272015655577,0.552158273381,249,0.121819960861,307,0.150195694716
luxuries,26,1896,560,0.295358649789,0.558928571429,247,0.130274261603,313,0.165084388186
luxuries,27,1748,479,0.274027459954,0.599164926931,192,0.109839816934,287,0.164187643021
luxuries,28,1560,449,0.287820512821,0.556792873051,199,0.127564102564,250,0.160256410256
luxuries,29,1436,410,0.285515320334,0.59756097561,165,0.114902506964,245,0.17061281337
luxuries,30,1396,396,0.283667621777,0.565656565657,172,0.123209169054,224,0.160458452722
luxuries,31,1193,339,0.284157585918,0.616519174041,130,0.10896898575,209,0.175188600168
luxuries,32,1147,316,0.275501307759,0.591772151899,129,0.112467306016,187,0.163034001744
luxuries,33,1075,319,0.296744186047,0.586206896552,132,0.122790697674,187,0.173953488372
luxuries,34,950,269,0.283157894737,0.587360594796,111,0.116842105263,158,0.166315789474
luxuries,35,930,262,0.281720430108,0.572519083969,112,0.120430107527,150,0.161290322581
luxuries,36,820,252,0.307317073171,0.599206349206,101,0.123170731707,151,0.184146341463
luxuries,37,753,201,0.266932270916,0.611940298507,78,0.103585657371,123,0.163346613546
luxuries,38,703,184,0.26173541963,0.565217391304,80,0.113798008535,104,0.147937411095
luxuries,39,699,187,0.267525035765,0.545454545455,85,0.121602288984,102,0.145922746781
luxuries,40,610,172,0.281967213115,0.488372093023,88,0.144262295082,84,0.137704918033
luxuries,41,645,188,0.291472868217,0.606382978723,74,0.114728682171,114,0.176744186047
luxuries,42,573,162,0.282722513089,0.592592592593,66,0.115183246073,96,0.167539267016
luxuries,43,532,144,0.270676691729,0.680555555556,46,0.0864661654135,98,0.184210526316
luxuries,44,491,139,0.283095723014,0.625899280576,52,0.105906313646,87,0.177189409369
luxuries,45,449,146,0.325167037862,0.554794520548,65,0.144766146993,81,0.180400890869
luxuries,46,408,127,0.311274509804,0.574803149606,54,0.132352941176,73,0.178921568627
luxuries,47,390,123,0.315384615385,0.650406504065,43,0.110256410256,80,0.205128205128
luxuries,48,373,123,0.329758713137,0.666666666667,41,0.109919571046,82,0.219839142091
luxuries,49,390,101,0.258974358974,0.544554455446,46,0.117948717949,55,0.141025641026
luxuries,50,337,98,0.290801186944,0.591836734694,40,0.118694362018,58,0.172106824926
luxuries,51,313,102,0.325878594249,0.549019607843,46,0.14696485623,56,0.178913738019
luxuries,52,317,89,0.280757097792,0.573033707865,38,0.119873817035,51,0.160883280757
luxuries,53,268,64,0.238805970149,0.40625,38,0.141791044776,26,0.0970149253731
luxuries,54,271,65,0.239852398524,0.584615384615,27,0.09963099631,38,0.140221402214
luxuries,55,281,75,0.266903914591,0.653333333333,26,0.0925266903915,49,0.174377224199
luxuries,56,262,76,0.290076335878,0.631578947368,28,0.106870229008,48,0.18320610687
luxuries,57,241,61,0.253112033195,0.639344262295,22,0.0912863070539,39,0.161825726141
luxuries,58,244,72,0.295081967213,0.680555555556,23,0.094262295082,49,0.200819672131
luxuries,59,223,59,0.264573991031,0.508474576271,29,0.130044843049,30,0.134529147982
luxuries,60,230,67,0.291304347826,0.686567164179,21,0.0913043478261,46,0.2
luxuries,61,219,59,0.269406392694,0.474576271186,31,0.141552511416,28,0.127853881279
luxuries,62,207,56,0.270531400966,0.642857142857,20,0.0966183574879,36,0.173913043478
luxuries,63,165,52,0.315151515152,0.557692307692,23,0.139393939394,29,0.175757575758
luxuries,64,170,41,0.241176470588,0.731707317073,11,0.0647058823529,30,0.176470588235
luxuries,65,158,53,0.335443037975,0.679245283019,17,0.107594936709,36,0.227848101266
luxuries,66,162,58,0.358024691358,0.603448275862,23,0.141975308642,35,0.216049382716
luxuries,67,153,41,0.267973856209,0.658536585366,14,0.0915032679739,27,0.176470588235
luxuries,68,168,42,0.25,0.642857142857,15,0.0892857142857,27,0.160714285714
luxuries,69,142,33,0.232394366197,0.575757575758,14,0.0985915492958,19,0.133802816901
luxuries,70,157,48,0.305732484076,0.583333333333,20,0.127388535032,28,0.178343949045
luxuries,71,130,27,0.207692307692,0.592592592593,11,0.0846153846154,16,0.123076923077
luxuries,72,142,33,0.232394366197,0.69696969697,10,0.0704225352113,23,0.161971830986
luxuries,73,125,34,0.272,0.705882352941,10,0.08,24,0.192
luxuries,74,100,25,0.25,0.64,9,0.09,16,0.16
luxuries,75,119,34,0.285714285714,0.588235294118,14,0.117647058824,20,0.168067226891
luxuries,76,94,16,0.170212765957,0.3125,11,0.117021276596,5,0.0531914893617
luxuries,77,96,29,0.302083333333,0.689655172414,9,0.09375,20,0.208333333333
luxuries,78,91,20,0.21978021978,0.7,6,0.0659340659341,14,0.153846153846
luxuries,79,120,26,0.216666666667,0.653846153846,9,0.075,17,0.141666666667
luxuries,80,97,29,0.298969072165,0.655172413793,10,0.103092783505,19,0.19587628866
luxuries,81,78,17,0.217948717949,0.588235294118,7,0.0897435897436,10,0.128205128205
luxuries,82,73,17,0.232876712329,0.647058823529,6,0.0821917808219,11,0.150684931507
luxuries,83,90,21,0.233333333333,0.761904761905,5,0.0555555555556,16,0.177777777778
luxuries,84,62,22,0.354838709677,0.409090909091,13,0.209677419355,9,0.145161290323
luxuries,85,90,20,0.222222222222,0.55,9,0.1,11,0.122222222222
luxuries,86,73,14,0.191780821918,0.714285714286,4,0.0547945205479,10,0.13698630137
luxuries,87,63,12,0.190476190476,0.75,3,0.047619047619,9,0.142857142857
luxuries,88,61,14,0.229508196721,0.5,7,0.114754098361,7,0.114754098361
luxuries,89,67,23,0.34328358209,0.652173913043,8,0.119402985075,15,0.223880597015
luxuries,90,59,16,0.271186440678,0.6875,5,0.0847457627119,11,0.186440677966
luxuries,91,49,10,0.204081632653,0.5,5,0.102040816327,5,0.102040816327
luxuries,92,76,19,0.25,0.684210526316,6,0.0789473684211,13,0.171052631579
luxuries,93,69,18,0.260869565217,0.388888888889,11,0.159420289855,7,0.101449275362
luxuries,94,49,13,0.265306122449,0.846153846154,2,0.0408163265306,11,0.224489795918
luxuries,95,55,14,0.254545454545,0.571428571429,6,0.109090909091,8,0.145454545455
luxuries,96,48,11,0.229166666667,0.363636363636,7,0.145833333333,4,0.0833333333333
luxuries,97,44,6,0.136363636364,0.5,3,0.0681818181818,3,0.0681818181818
luxuries,98,47,6,0.127659574468,0.5,3,0.063829787234,3,0.063829787234
luxuries,99,52,12,0.230769230769,0.833333333333,2,0.0384615384615,10,0.192307692308
luxuries,100,35,7,0.2,0.428571428571,4,0.114285714286,3,0.0857142857143
luxuries,101,49,14,0.285714285714,0.571428571429,6,0.122448979592,8,0.163265306122
luxuries,102,36,8,0.222222222222,0.75,2,0.0555555555556,6,0.166666666667
luxuries,103,36,9,0.25,0.555555555556,4,0.111111111111,5,0.138888888889
luxuries,104,43,16,0.372093023256,0.5625,7,0.162790697674,9,0.209302325581
luxuries,105,42,9,0.214285714286,0.555555555556,4,0.0952380952381,5,0.119047619048
luxuries,106,40,7,0.175,0.428571428571,4,0.1,3,0.075
luxuries,107,38,8,0.210526315789,0.875,1,0.0263157894737,7,0.184210526316
luxuries,108,35,9,0.257142857143,0.555555555556,4,0.114285714286,5,0.142857142857
luxuries,109,44,14,0.318181818182,0.571428571429,6,0.136363636364,8,0.181818181818
luxuries,110,38,13,0.342105263158,0.384615384615,8,0.210526315789,5,0.131578947368
luxuries,111,38,7,0.184210526316,0.714285714286,2,0.0526315789474,5,0.131578947368
luxuries,112,32,4,0.125,0.25,3,0.09375,1,0.03125
luxuries,113,33,10,0.30303030303,0.4,6,0.181818181818,4,0.121212121212
luxuries,114,35,10,0.285714285714,0.9,1,0.0285714285714,9,0.257142857143
luxuries,115,39,8,0.205128205128,0.75,2,0.0512820512821,6,0.153846153846
luxuries,116,27,6,0.222222222222,0.666666666667,2,0.0740740740741,4,0.148148148148
luxuries,117,34,10,0.294117647059,0.6,4,0.117647058824,6,0.176470588235
luxuries,118,34,12,0.352941176471,0.666666666667,4,0.117647058824,8,0.235294117647
luxuries,119,28,7,0.25,0.428571428571,4,0.142857142857,3,0.107142857143
luxuries,120,14,4,0.285714285714,0.5,2,0.142857142857,2,0.142857142857
luxuries,121,24,7,0.291666666667,0.571428571429,3,0.125,4,0.166666666667
luxuries,122,30,8,0.266666666667,0.625,3,0.1,5,0.166666666667
luxuries,123,34,7,0.205882352941,0.571428571429,3,0.0882352941176,4,0.117647058824
luxuries,124,29,6,0.206896551724,0.5,3,0.103448275862,3,0.103448275862
luxuries,125,26,4,0.153846153846,0.0,4,0.153846153846,0,0.0
luxuries,126,22,6,0.272727272727,0.5,3,0.136363636364,3,0.136363636364
luxuries,127,19,2,0.105263157895,0.5,1,0.0526315789474,1,0.0526315789474
luxuries,128,16,4,0.25,1.0,0,0.0,4,0.25
luxuries,129,15,7,0.466666666667,0.857142857143,1,0.0666666666667,6,0.4
luxuries,130,12,4,0.333333333333,0.25,3,0.25,1,0.0833333333333
luxuries,131,19,5,0.263157894737,1.0,0,0.0,5,0.263157894737
luxuries,132,14,4,0.285714285714,0.25,3,0.214285714286,1,0.0714285714286
luxuries,133,16,6,0.375,1.0,0,0.0,6,0.375
luxuries,134,14,4,0.285714285714,0.25,3,0.214285714286,1,0.0714285714286
luxuries,135,15,3,0.2,0.666666666667,1,0.0666666666667,2,0.133333333333
luxuries,136,13,1,0.0769230769231,1.0,0,0.0,1,0.0769230769231
luxuries,137,23,3,0.130434782609,0.666666666667,1,0.0434782608696,2,0.0869565217391
luxuries,138,18,4,0.222222222222,0.75,1,0.0555555555556,3,0.166666666667
luxuries,139,14,2,0.142857142857,0.5,1,0.0714285714286,1,0.0714285714286
luxuries,140,22,6,0.272727272727,0.5,3,0.136363636364,3,0.136363636364
luxuries,141,12,5,0.416666666667,0.4,3,0.25,2,0.166666666667
luxuries,142,11,2,0.181818181818,1.0,0,0.0,2,0.181818181818
luxuries,143,13,4,0.307692307692,0.25,3,0.230769230769,1,0.0769230769231
luxuries,144,19,8,0.421052631579,0.625,3,0.157894736842,5,0.263157894737
luxuries,145,14,4,0.285714285714,0.5,2,0.142857142857,2,0.142857142857
luxuries,146,12,1,0.0833333333333,1.0,0,0.0,1,0.0833333333333
luxuries,147,20,6,0.3,0.5,3,0.15,3,0.15
luxuries,148,19,3,0.157894736842,0.333333333333,2,0.105263157895,1,0.0526315789474
luxuries,149,14,1,0.0714285714286,0.0,1,0.0714285714286,0,0.0
luxuries,150,9,1,0.111111111111,1.0,0,0.0,1,0.111111111111
luxuries,151,5,3,0.6,1.0,0,0.0,3,0.6
luxuries,152,15,3,0.2,1.0,0,0.0,3,0.2
luxuries,153,10,3,0.3,0.333333333333,2,0.2,1,0.1
luxuries,154,11,3,0.272727272727,0.0,3,0.272727272727,0,0.0
luxuries,155,5,1,0.2,0.0,1,0.2,0,0.0
luxuries,156,9,1,0.111111111111,1.0,0,0.0,1,0.111111111111
luxuries,157,10,4,0.4,1.0,0,0.0,4,0.4
luxuries,158,17,1,0.0588235294118,1.0,0,0.0,1,0.0588235294118
luxuries,159,8,2,0.25,0.5,1,0.125,1,0.125
luxuries,160,6,0,0.0,NULL,0,0.0,0,0.0
luxuries,161,10,1,0.1,1.0,0,0.0,1,0.1
luxuries,162,12,3,0.25,0.666666666667,1,0.0833333333333,2,0.166666666667
luxuries,163,4,2,0.5,0.5,1,0.25,1,0.25
luxuries,164,10,1,0.1,0.0,1,0.1,0,0.0
luxuries,165,13,3,0.230769230769,0.333333333333,2,0.153846153846,1,0.0769230769231
luxuries,166,9,1,0.111111111111,0.0,1,0.111111111111,0,0.0
luxuries,167,8,2,0.25,0.5,1,0.125,1,0.125
luxuries,168,8,5,0.625,0.2,4,0.5,1,0.125
luxuries,169,6,0,0.0,NULL,0,0.0,0,0.0
luxuries,170,11,2,0.181818181818,1.0,0,0.0,2,0.181818181818
luxuries,171,4,1,0.25,1.0,0,0.0,1,0.25
luxuries,172,15,3,0.2,0.333333333333,2,0.133333333333,1,0.0666666666667
luxuries,173,10,0,0.0,NULL,0,0.0,0,0.0
luxuries,174,13,5,0.384615384615,0.8,1,0.0769230769231,4,0.307692307692
luxuries,175,7,2,0.285714285714,0.5,1,0.142857142857,1,0.142857142857
luxuries,176,13,3,0.230769230769,1.0,0,0.0,3,0.230769230769
luxuries,177,8,0,0.0,NULL,0,0.0,0,0.0
luxuries,178,9,4,0.444444444444,1.0,0,0.0,4,0.444444444444
luxuries,179,5,1,0.2,1.0,0,0.0,1,0.2
luxuries,180,8,3,0.375,0.333333333333,2,0.25,1,0.125
luxuries,181,10,4,0.4,0.5,2,0.2,2,0.2
luxuries,182,2,1,0.5,1.0,0,0.0,1,0.5
luxuries,183,4,0,0.0,NULL,0,0.0,0,0.0
luxuries,184,6,5,0.833333333333,0.4,3,0.5,2,0.333333333333
luxuries,185,14,3,0.214285714286,1.0,0,0.0,3,0.214285714286
luxuries,186,5,1,0.2,0.0,1,0.2,0,0.0
luxuries,187,7,2,0.285714285714,0.5,1,0.142857142857,1,0.142857142857
luxuries,188,5,2,0.4,1.0,0,0.0,2,0.4
luxuries,189,7,1,0.142857142857,1.0,0,0.0,1,0.142857142857
luxuries,190,5,1,0.2,0.0,1,0.2,0,0.0
luxuries,191,6,3,0.5,0.666666666667,1,0.166666666667,2,0.333333333333
luxuries,192,5,0,0.0,NULL,0,0.0,0,0.0
luxuries,193,11,6,0.545454545455,0.5,3,0.272727272727,3,0.272727272727
luxuries,194,5,0,0.0,NULL,0,0.0,0,0.0
luxuries,195,4,2,0.5,1.0,0,0.0,2,0.5
luxuries,196,4,0,0.0,NULL,0,0.0,0,0.0
luxuries,197,10,4,0.4,0.5,2,0.2,2,0.2
luxuries,198,4,1,0.25,0.0,1,0.25,0,0.0
luxuries,199,7,2,0.285714285714,1.0,0,0.0,2,0.285714285714
luxuries,200,6,2,0.333333333333,1.0,0,0.0,2,0.333333333333
luxuries,201,3,1,0.333333333333,0.0,1,0.333333333333,0,0.0
luxuries,202,3,0,0.0,NULL,0,0.0,0,0.0
luxuries,203,2,1,0.5,1.0,0,0.0,1,0.5
luxuries,204,4,0,0.0,NULL,0,0.0,0,0.0
luxuries,205,3,1,0.333333333333,0.0,1,0.333333333333,0,0.0
luxuries,206,3,1,0.333333333333,0.0,1,0.333333333333,0,0.0
luxuries,207,10,1,0.1,0.0,1,0.1,0,0.0
luxuries,208,5,2,0.4,0.5,1,0.2,1,0.2
luxuries,209,3,1,0.333333333333,1.0,0,0.0,1,0.333333333333
luxuries,210,4,1,0.25,1.0,0,0.0,1,0.25
luxuries,211,4,1,0.25,1.0,0,0.0,1,0.25
luxuries,212,2,0,0.0,NULL,0,0.0,0,0.0
luxuries,213,6,2,0.333333333333,0.0,2,0.333333333333,0,0.0
luxuries,214,2,1,0.5,0.0,1,0.5,0,0.0
luxuries,215,6,2,0.333333333333,0.5,1,0.166666666667,1,0.166666666667
luxuries,216,2,0,0.0,NULL,0,0.0,0,0.0
luxuries,217,3,2,0.666666666667,1.0,0,0.0,2,0.666666666667
luxuries,219,4,0,0.0,NULL,0,0.0,0,0.0
luxuries,220,4,0,0.0,NULL,0,0.0,0,0.0
luxuries,221,2,1,0.5,0.0,1,0.5,0,0.0
luxuries,222,3,1,0.333333333333,0.0,1,0.333333333333,0,0.0
luxuries,223,2,0,0.0,NULL,0,0.0,0,0.0
luxuries,224,5,3,0.6,0.333333333333,2,0.4,1,0.2
luxuries,225,6,2,0.333333333333,1.0,0,0.0,2,0.333333333333
luxuries,226,5,0,0.0,NULL,0,0.0,0,0.0
luxuries,227,5,1,0.2,1.0,0,0.0,1,0.2
luxuries,228,4,0,0.0,NULL,0,0.0,0,0.0
luxuries,229,4,0,0.0,NULL,0,0.0,0,0.0
luxuries,230,4,0,0.0,NULL,0,0.0,0,0.0
luxuries,231,3,2,0.666666666667,1.0,0,0.0,2,0.666666666667
luxuries,232,6,1,0.166666666667,1.0,0,0.0,1,0.166666666667
luxuries,233,4,0,0.0,NULL,0,0.0,0,0.0
luxuries,234,3,1,0.333333333333,1.0,0,0.0,1,0.333333333333
luxuries,235,2,0,0.0,NULL,0,0.0,0,0.0
luxuries,236,5,1,0.2,0.0,1,0.2,0,0.0
luxuries,237,4,0,0.0,NULL,0,0.0,0,0.0
luxuries,238,2,1,0.5,1.0,0,0.0,1,0.5
luxuries,239,3,2,0.666666666667,1.0,0,0.0,2,0.666666666667
luxuries,240,2,1,0.5,1.0,0,0.0,1,0.5
luxuries,241,2,2,1.0,1.0,0,0.0,2,1.0
luxuries,242,2,0,0.0,NULL,0,0.0,0,0.0
luxuries,243,1,0,0.0,NULL,0,0.0,0,0.0
luxuries,244,1,0,0.0,NULL,0,0.0,0,0.0
luxuries,245,3,2,0.666666666667,1.0,0,0.0,2,0.666666666667
luxuries,246,1,1,1.0,1.0,0,0.0,1,1.0
luxuries,247,3,2,0.666666666667,0.5,1,0.333333333333,1,0.333333333333
luxuries,249,2,0,0.0,NULL,0,0.0,0,0.0
luxuries,250,3,2,0.666666666667,0.5,1,0.333333333333,1,0.333333333333
luxuries,251,2,0,0.0,NULL,0,0.0,0,0.0
luxuries,252,1,0,0.0,NULL,0,0.0,0,0.0
luxuries,253,1,0,0.0,NULL,0,0.0,0,0.0
luxuries,254,4,0,0.0,NULL,0,0.0,0,0.0
luxuries,256,2,0,0.0,NULL,0,0.0,0,0.0
luxuries,257,2,1,0.5,1.0,0,0.0,1,0.5
luxuries,258,3,0,0.0,NULL,0,0.0,0,0.0
luxuries,259,4,0,0.0,NULL,0,0.0,0,0.0
luxuries,260,3,0,0.0,NULL,0,0.0,0,0.0
luxuries,262,3,0,0.0,NULL,0,0.0,0,0.0
luxuries,264,1,0,0.0,NULL,0,0.0,0,0.0
luxuries,266,2,2,1.0,1.0,0,0.0,2,1.0
luxuries,267,2,2,1.0,1.0,0,0.0,2,1.0
luxuries,269,2,0,0.0,NULL,0,0.0,0,0.0
luxuries,270,2,1,0.5,0.0,1,0.5,0,0.0
luxuries,271,2,1,0.5,1.0,0,0.0,1,0.5
luxuries,272,2,0,0.0,NULL,0,0.0,0,0.0
luxuries,273,2,2,1.0,0.5,1,0.5,1,0.5
luxuries,274,2,0,0.0,NULL,0,0.0,0,0.0
luxuries,275,2,0,0.0,NULL,0,0.0,0,0.0
luxuries,276,2,0,0.0,NULL,0,0.0,0,0.0
luxuries,277,1,0,0.0,NULL,0,0.0,0,0.0
luxuries,278,1,0,0.0,NULL,0,0.0,0,0.0
luxuries,279,4,0,0.0,NULL,0,0.0,0,0.0
luxuries,280,5,1,0.2,1.0,0,0.0,1,0.2
luxuries,281,1,0,0.0,NULL,0,0.0,0,0.0
luxuries,282,1,0,0.0,NULL,0,0.0,0,0.0
luxuries,283,1,0,0.0,NULL,0,0.0,0,0.0
luxuries,284,1,0,0.0,NULL,0,0.0,0,0.0
luxuries,286,1,0,0.0,NULL,0,0.0,0,0.0
luxuries,288,1,0,0.0,NULL,0,0.0,0,0.0
luxuries,289,1,0,0.0,NULL,0,0.0,0,0.0
luxuries,290,1,1,1.0,1.0,0,0.0,1,1.0
luxuries,291,3,0,0.0,NULL,0,0.0,0,0.0
luxuries,292,3,0,0.0,NULL,0,0.0,0,0.0
luxuries,293,2,0,0.0,NULL,0,0.0,0,0.0
luxuries,295,2,1,0.5,1.0,0,0.0,1,0.5
luxuries,298,2,0,0.0,NULL,0,0.0,0,0.0
luxuries,299,5,0,0.0,NULL,0,0.0,0,0.0
luxuries,301,1,0,0.0,NULL,0,0.0,0,0.0
luxuries,302,1,1,1.0,1.0,0,0.0,1,1.0
luxuries,303,2,0,0.0,NULL,0,0.0,0,0.0
luxuries,304,2,0,0.0,NULL,0,0.0,0,0.0
luxuries,305,1,0,0.0,NULL,0,0.0,0,0.0
luxuries,307,4,0,0.0,NULL,0,0.0,0,0.0
luxuries,311,1,0,0.0,NULL,0,0.0,0,0.0
luxuries,313,1,0,0.0,NULL,0,0.0,0,0.0
luxuries,315,1,0,0.0,NULL,0,0.0,0,0.0
luxuries,316,2,1,0.5,0.0,1,0.5,0,0.0
luxuries,318,3,1,0.333333333333,1.0,0,0.0,1,0.333333333333
luxuries,319,1,0,0.0,NULL,0,0.0,0,0.0
luxuries,322,3,0,0.0,NULL,0,0.0,0,0.0
luxuries,325,2,0,0.0,NULL,0,0.0,0,0.0
luxuries,326,1,0,0.0,NULL,0,0.0,0,0.0
luxuries,327,2,0,0.0,NULL,0,0.0,0,0.0
luxuries,328,1,0,0.0,NULL,0,0.0,0,0.0
luxuries,330,2,0,0.0,NULL,0,0.0,0,0.0
luxuries,331,2,0,0.0,NULL,0,0.0,0,0.0
luxuries,332,2,1,0.5,1.0,0,0.0,1,0.5
luxuries,333,1,0,0.0,NULL,0,0.0,0,0.0
luxuries,334,1,1,1.0,1.0,0,0.0,1,1.0
luxuries,335,1,1,1.0,0.0,1,1.0,0,0.0
luxuries,337,1,0,0.0,NULL,0,0.0,0,0.0
luxuries,340,1,0,0.0,NULL,0,0.0,0,0.0
luxuries,341,2,0,0.0,NULL,0,0.0,0,0.0
luxuries,342,2,0,0.0,NULL,0,0.0,0,0.0
luxuries,346,1,0,0.0,NULL,0,0.0,0,0.0
luxuries,348,1,1,1.0,1.0,0,0.0,1,1.0
luxuries,349,1,0,0.0,NULL,0,0.0,0,0.0
luxuries,353,1,0,0.0,NULL,0,0.0,0,0.0
luxuries,355,1,0,0.0,NULL,0,0.0,0,0.0
luxuries,356,1,1,1.0,0.0,1,1.0,0,0.0
luxuries,357,1,1,1.0,1.0,0,0.0,1,1.0
luxuries,359,1,0,0.0,NULL,0,0.0,0,0.0
luxuries,361,2,0,0.0,NULL,0,0.0,0,0.0
luxuries,364,1,0,0.0,NULL,0,0.0,0,0.0
luxuries,366,1,0,0.0,NULL,0,0.0,0,0.0
luxuries,367,2,1,0.5,0.0,1,0.5,0,0.0
luxuries,368,1,0,0.0,NULL,0,0.0,0,0.0
luxuries,372,1,0,0.0,NULL,0,0.0,0,0.0
luxuries,374,1,0,0.0,NULL,0,0.0,0,0.0
luxuries,375,2,0,0.0,NULL,0,0.0,0,0.0
luxuries,376,1,0,0.0,NULL,0,0.0,0,0.0
luxuries,380,1,0,0.0,NULL,0,0.0,0,0.0
luxuries,384,1,0,0.0,NULL,0,0.0,0,0.0
luxuries,390,1,1,1.0,1.0,0,0.0,1,1.0
luxuries,393,1,0,0.0,NULL,0,0.0,0,0.0
luxuries,394,1,0,0.0,NULL,0,0.0,0,0.0
luxuries,400,2,1,0.5,1.0,0,0.0,1,0.5
luxuries,407,1,0,0.0,NULL,0,0.0,0,0.0
luxuries,409,1,0,0.0,NULL,0,0.0,0,0.0
luxuries,414,1,0,0.0,NULL,0,0.0,0,0.0
luxuries,415,1,0,0.0,NULL,0,0.0,0,0.0
luxuries,419,1,0,0.0,NULL,0,0.0,0,0.0
luxuries,420,1,0,0.0,NULL,0,0.0,0,0.0
luxuries,421,1,0,0.0,NULL,0,0.0,0,0.0
luxuries,423,1,0,0.0,NULL,0,0.0,0,0.0
luxuries,424,1,0,0.0,NULL,0,0.0,0,0.0
luxuries,429,1,0,0.0,NULL,0,0.0,0,0.0
luxuries,431,1,1,1.0,1.0,0,0.0,1,1.0
luxuries,432,1,0,0.0,NULL,0,0.0,0,0.0
luxuries,434,1,1,1.0,0.0,1,1.0,0,0.0
luxuries,438,1,0,0.0,NULL,0,0.0,0,0.0
luxuries,442,2,0,0.0,NULL,0,0.0,0,0.0
luxuries,447,1,0,0.0,NULL,0,0.0,0,0.0
luxuries,456,1,0,0.0,NULL,0,0.0,0,0.0
luxuries,457,3,1,0.333333333333,1.0,0,0.0,1,0.333333333333
luxuries,458,1,1,1.0,1.0,0,0.0,1,1.0
luxuries,460,1,1,1.0,0.0,1,1.0,0,0.0
luxuries,462,1,0,0.0,NULL,0,0.0,0,0.0
luxuries,465,1,0,0.0,NULL,0,0.0,0,0.0
luxuries,473,1,0,0.0,NULL,0,0.0,0,0.0
luxuries,474,1,0,0.0,NULL,0,0.0,0,0.0
luxuries,475,1,0,0.0,NULL,0,0.0,0,0.0
luxuries,479,1,0,0.0,NULL,0,0.0,0,0.0
luxuries,488,1,0,0.0,NULL,0,0.0,0,0.0
luxuries,494,1,0,0.0,NULL,0,0.0,0,0.0
luxuries,496,3,0,0.0,NULL,0,0.0,0,0.0
luxuries,499,1,0,0.0,NULL,0,0.0,0,0.0
luxuries,504,1,0,0.0,NULL,0,0.0,0,0.0
luxuries,505,1,0,0.0,NULL,0,0.0,0,0.0
luxuries,508,1,0,0.0,NULL,0,0.0,0,0.0
luxuries,510,2,1,0.5,1.0,0,0.0,1,0.5
luxuries,514,1,1,1.0,1.0,0,0.0,1,1.0
luxuries,524,1,0,0.0,NULL,0,0.0,0,0.0
luxuries,528,1,0,0.0,NULL,0,0.0,0,0.0
luxuries,543,1,1,1.0,0.0,1,1.0,0,0.0
luxuries,547,1,0,0.0,NULL,0,0.0,0,0.0
luxuries,552,1,0,0.0,NULL,0,0.0,0,0.0
luxuries,564,1,1,1.0,1.0,0,0.0,1,1.0
luxuries,582,1,0,0.0,NULL,0,0.0,0,0.0
luxuries,624,1,0,0.0,NULL,0,0.0,0,0.0
luxuries,636,1,1,1.0,1.0,0,0.0,1,1.0
luxuries,668,1,0,0.0,NULL,0,0.0,0,0.0
luxuries,671,1,0,0.0,NULL,0,0.0,0,0.0
luxuries,695,1,0,0.0,NULL,0,0.0,0,0.0
luxuries,705,1,0,0.0,NULL,0,0.0,0,0.0
luxuries,710,1,0,0.0,NULL,0,0.0,0,0.0
luxuries,745,1,0,0.0,NULL,0,0.0,0,0.0
luxuries,832,1,0,0.0,NULL,0,0.0,0,0.0
luxuries,925,1,1,1.0,0.0,1,1.0,0,0.0
luxuries,961,1,0,0.0,NULL,0,0.0,0,0.0
luxuries,970,1,0,0.0,NULL,0,0.0,0,0.0
luxuries,1172,1,0,0.0,NULL,0,0.0,0,0.0
luxuries,1474,1,0,0.0,NULL,0,0.0,0,0.0
mother_baby,0,6817998,541228,0.079382246812,0.296959876429,380505,0.0558089046081,160723,0.023573342204
mother_baby,1,359309,43521,0.121124157758,0.388961650697,26593,0.0740115054173,16928,0.047112652341
mother_baby,2,150526,21766,0.144599604055,0.406781218414,12912,0.0857792009354,8854,0.0588204031197
mother_baby,3,69331,10202,0.147149182905,0.436581062537,5748,0.082906636281,4454,0.0642425466242
mother_baby,4,44001,6936,0.157632781073,0.459054209919,3752,0.0852707893002,3184,0.0723619917729
mother_baby,5,25650,3964,0.154541910331,0.469223007064,2104,0.0820272904483,1860,0.072514619883
mother_baby,6,19968,3186,0.159555288462,0.475831763967,1670,0.0836338141026,1516,0.075921474359
mother_baby,7,12540,2007,0.16004784689,0.474339810663,1055,0.0841307814992,952,0.0759170653907
mother_baby,8,9941,1593,0.160245448144,0.4934086629,807,0.0811789558395,786,0.0790664923046
mother_baby,9,7185,1173,0.163256784969,0.520034100597,563,0.0783576896312,610,0.0848990953375
mother_baby,10,5868,965,0.164451261077,0.543005181347,441,0.0751533742331,524,0.0892978868439
mother_baby,11,4410,730,0.165532879819,0.48904109589,373,0.0845804988662,357,0.0809523809524
mother_baby,12,3871,623,0.160940325497,0.534510433387,290,0.0749160423663,333,0.086024283131
mother_baby,13,2853,491,0.172099544339,0.537678207739,227,0.0795653697862,264,0.0925341745531
mother_baby,14,2504,447,0.178514376997,0.525727069351,212,0.0846645367412,235,0.0938498402556
mother_baby,15,2068,346,0.167311411992,0.523121387283,165,0.0797872340426,181,0.0875241779497
mother_baby,16,1796,291,0.162026726058,0.567010309278,126,0.0701559020045,165,0.0918708240535
mother_baby,17,1326,217,0.163650075415,0.534562211982,101,0.0761689291101,116,0.0874811463047
mother_baby,18,1310,228,0.174045801527,0.583333333333,95,0.0725190839695,133,0.101526717557
mother_baby,19,1040,180,0.173076923077,0.55,81,0.0778846153846,99,0.0951923076923
mother_baby,20,1068,164,0.153558052434,0.44512195122,91,0.0852059925094,73,0.0683520599251
mother_baby,21,807,133,0.164807930607,0.488721804511,68,0.0842627013631,65,0.0805452292441
mother_baby,22,691,116,0.167872648336,0.551724137931,52,0.0752532561505,64,0.0926193921852
mother_baby,23,642,105,0.163551401869,0.609523809524,41,0.0638629283489,64,0.0996884735202
mother_baby,24,613,89,0.145187601958,0.516853932584,43,0.0701468189233,46,0.0750407830343
mother_baby,25,497,81,0.162977867203,0.592592592593,33,0.0663983903421,48,0.0965794768612
mother_baby,26,430,69,0.160465116279,0.565217391304,30,0.0697674418605,39,0.0906976744186
mother_baby,27,346,72,0.208092485549,0.458333333333,39,0.112716763006,33,0.0953757225434
mother_baby,28,354,51,0.14406779661,0.470588235294,27,0.0762711864407,24,0.0677966101695
mother_baby,29,310,59,0.190322580645,0.338983050847,39,0.125806451613,20,0.0645161290323
mother_baby,30,300,48,0.16,0.5625,21,0.07,27,0.09
mother_baby,31,262,33,0.125954198473,0.393939393939,20,0.0763358778626,13,0.0496183206107
mother_baby,32,257,46,0.178988326848,0.652173913043,16,0.0622568093385,30,0.11673151751
mother_baby,33,236,36,0.152542372881,0.527777777778,17,0.0720338983051,19,0.0805084745763
mother_baby,34,235,38,0.16170212766,0.526315789474,18,0.0765957446809,20,0.0851063829787
mother_baby,35,187,30,0.160427807487,0.566666666667,13,0.0695187165775,17,0.0909090909091
mother_baby,36,182,27,0.148351648352,0.407407407407,16,0.0879120879121,11,0.0604395604396
mother_baby,37,164,15,0.0914634146341,0.6,6,0.0365853658537,9,0.0548780487805
mother_baby,38,162,26,0.16049382716,0.538461538462,12,0.0740740740741,14,0.0864197530864
mother_baby,39,142,15,0.105633802817,0.666666666667,5,0.0352112676056,10,0.0704225352113
mother_baby,40,127,20,0.157480314961,0.65,7,0.0551181102362,13,0.102362204724
mother_baby,41,109,12,0.110091743119,0.416666666667,7,0.0642201834862,5,0.045871559633
mother_baby,42,110,12,0.109090909091,0.416666666667,7,0.0636363636364,5,0.0454545454545
mother_baby,43,116,11,0.0948275862069,0.545454545455,5,0.0431034482759,6,0.051724137931
mother_baby,44,99,18,0.181818181818,0.5,9,0.0909090909091,9,0.0909090909091
mother_baby,45,107,24,0.224299065421,0.583333333333,10,0.0934579439252,14,0.130841121495
mother_baby,46,89,9,0.101123595506,0.111111111111,8,0.0898876404494,1,0.0112359550562
mother_baby,47,60,9,0.15,0.333333333333,6,0.1,3,0.05
mother_baby,48,72,12,0.166666666667,0.5,6,0.0833333333333,6,0.0833333333333
mother_baby,49,68,12,0.176470588235,0.5,6,0.0882352941176,6,0.0882352941176
mother_baby,50,65,10,0.153846153846,0.6,4,0.0615384615385,6,0.0923076923077
mother_baby,51,58,12,0.206896551724,0.333333333333,8,0.137931034483,4,0.0689655172414
mother_baby,52,71,16,0.225352112676,0.5,8,0.112676056338,8,0.112676056338
mother_baby,53,57,7,0.122807017544,0.571428571429,3,0.0526315789474,4,0.0701754385965
mother_baby,54,60,6,0.1,0.833333333333,1,0.0166666666667,5,0.0833333333333
mother_baby,55,54,11,0.203703703704,0.636363636364,4,0.0740740740741,7,0.12962962963
mother_baby,56,50,6,0.12,0.5,3,0.06,3,0.06
mother_baby,57,46,4,0.0869565217391,0.25,3,0.0652173913043,1,0.0217391304348
mother_baby,58,47,4,0.0851063829787,0.5,2,0.0425531914894,2,0.0425531914894
mother_baby,59,44,7,0.159090909091,0.714285714286,2,0.0454545454545,5,0.113636363636
mother_baby,60,42,7,0.166666666667,0.428571428571,4,0.0952380952381,3,0.0714285714286
mother_baby,61,29,7,0.241379310345,0.428571428571,4,0.137931034483,3,0.103448275862
mother_baby,62,36,7,0.194444444444,0.857142857143,1,0.0277777777778,6,0.166666666667
mother_baby,63,36,4,0.111111111111,0.75,1,0.0277777777778,3,0.0833333333333
mother_baby,64,26,3,0.115384615385,0.666666666667,1,0.0384615384615,2,0.0769230769231
mother_baby,65,34,6,0.176470588235,0.166666666667,5,0.147058823529,1,0.0294117647059
mother_baby,66,39,11,0.282051282051,0.545454545455,5,0.128205128205,6,0.153846153846
mother_baby,67,34,4,0.117647058824,0.0,4,0.117647058824,0,0.0
mother_baby,68,28,3,0.107142857143,0.666666666667,1,0.0357142857143,2,0.0714285714286
mother_baby,69,27,4,0.148148148148,0.5,2,0.0740740740741,2,0.0740740740741
mother_baby,70,19,2,0.105263157895,0.5,1,0.0526315789474,1,0.0526315789474
mother_baby,71,16,0,0.0,NULL,0,0.0,0,0.0
mother_baby,72,29,3,0.103448275862,1.0,0,0.0,3,0.103448275862
mother_baby,73,17,1,0.0588235294118,1.0,0,0.0,1,0.0588235294118
mother_baby,74,26,3,0.115384615385,1.0,0,0.0,3,0.115384615385
mother_baby,75,22,4,0.181818181818,0.5,2,0.0909090909091,2,0.0909090909091
mother_baby,76,22,0,0.0,NULL,0,0.0,0,0.0
mother_baby,77,23,4,0.173913043478,0.75,1,0.0434782608696,3,0.130434782609
mother_baby,78,13,1,0.0769230769231,1.0,0,0.0,1,0.0769230769231
mother_baby,79,18,1,0.0555555555556,1.0,0,0.0,1,0.0555555555556
mother_baby,80,13,2,0.153846153846,0.5,1,0.0769230769231,1,0.0769230769231
mother_baby,81,21,2,0.0952380952381,0.5,1,0.047619047619,1,0.047619047619
mother_baby,82,16,0,0.0,NULL,0,0.0,0,0.0
mother_baby,83,9,0,0.0,NULL,0,0.0,0,0.0
mother_baby,84,14,2,0.142857142857,1.0,0,0.0,2,0.142857142857
mother_baby,85,16,2,0.125,1.0,0,0.0,2,0.125
mother_baby,86,15,3,0.2,0.666666666667,1,0.0666666666667,2,0.133333333333
mother_baby,87,15,1,0.0666666666667,1.0,0,0.0,1,0.0666666666667
mother_baby,88,9,1,0.111111111111,0.0,1,0.111111111111,0,0.0
mother_baby,89,18,1,0.0555555555556,1.0,0,0.0,1,0.0555555555556
mother_baby,90,14,0,0.0,NULL,0,0.0,0,0.0
mother_baby,91,6,2,0.333333333333,0.0,2,0.333333333333,0,0.0
mother_baby,92,10,2,0.2,0.5,1,0.1,1,0.1
mother_baby,93,9,1,0.111111111111,1.0,0,0.0,1,0.111111111111
mother_baby,94,10,1,0.1,1.0,0,0.0,1,0.1
mother_baby,95,7,1,0.142857142857,0.0,1,0.142857142857,0,0.0
mother_baby,96,10,0,0.0,NULL,0,0.0,0,0.0
mother_baby,97,5,1,0.2,0.0,1,0.2,0,0.0
mother_baby,98,9,0,0.0,NULL,0,0.0,0,0.0
mother_baby,99,6,0,0.0,NULL,0,0.0,0,0.0
mother_baby,100,3,0,0.0,NULL,0,0.0,0,0.0
mother_baby,101,10,0,0.0,NULL,0,0.0,0,0.0
mother_baby,102,18,2,0.111111111111,1.0,0,0.0,2,0.111111111111
mother_baby,103,8,1,0.125,0.0,1,0.125,0,0.0
mother_baby,104,9,1,0.111111111111,0.0,1,0.111111111111,0,0.0
mother_baby,105,6,0,0.0,NULL,0,0.0,0,0.0
mother_baby,106,9,3,0.333333333333,1.0,0,0.0,3,0.333333333333
mother_baby,107,10,0,0.0,NULL,0,0.0,0,0.0
mother_baby,108,8,1,0.125,1.0,0,0.0,1,0.125
mother_baby,109,4,0,0.0,NULL,0,0.0,0,0.0
mother_baby,110,5,1,0.2,0.0,1,0.2,0,0.0
mother_baby,111,3,0,0.0,NULL,0,0.0,0,0.0
mother_baby,112,2,0,0.0,NULL,0,0.0,0,0.0
mother_baby,113,7,2,0.285714285714,0.0,2,0.285714285714,0,0.0
mother_baby,114,4,0,0.0,NULL,0,0.0,0,0.0
mother_baby,115,4,0,0.0,NULL,0,0.0,0,0.0
mother_baby,116,8,0,0.0,NULL,0,0.0,0,0.0
mother_baby,117,3,0,0.0,NULL,0,0.0,0,0.0
mother_baby,118,5,0,0.0,NULL,0,0.0,0,0.0
mother_baby,119,3,0,0.0,NULL,0,0.0,0,0.0
mother_baby,120,3,1,0.333333333333,1.0,0,0.0,1,0.333333333333
mother_baby,121,1,0,0.0,NULL,0,0.0,0,0.0
mother_baby,122,2,0,0.0,NULL,0,0.0,0,0.0
mother_baby,123,4,0,0.0,NULL,0,0.0,0,0.0
mother_baby,124,4,1,0.25,1.0,0,0.0,1,0.25
mother_baby,125,2,0,0.0,NULL,0,0.0,0,0.0
mother_baby,126,3,0,0.0,NULL,0,0.0,0,0.0
mother_baby,127,3,0,0.0,NULL,0,0.0,0,0.0
mother_baby,128,4,0,0.0,NULL,0,0.0,0,0.0
mother_baby,129,5,0,0.0,NULL,0,0.0,0,0.0
mother_baby,130,2,1,0.5,1.0,0,0.0,1,0.5
mother_baby,131,2,0,0.0,NULL,0,0.0,0,0.0
mother_baby,132,3,0,0.0,NULL,0,0.0,0,0.0
mother_baby,133,4,0,0.0,NULL,0,0.0,0,0.0
mother_baby,134,3,1,0.333333333333,1.0,0,0.0,1,0.333333333333
mother_baby,135,3,0,0.0,NULL,0,0.0,0,0.0
mother_baby,136,2,1,0.5,0.0,1,0.5,0,0.0
mother_baby,137,5,0,0.0,NULL,0,0.0,0,0.0
mother_baby,138,3,1,0.333333333333,0.0,1,0.333333333333,0,0.0
mother_baby,139,2,0,0.0,NULL,0,0.0,0,0.0
mother_baby,140,3,1,0.333333333333,0.0,1,0.333333333333,0,0.0
mother_baby,141,2,0,0.0,NULL,0,0.0,0,0.0
mother_baby,143,4,0,0.0,NULL,0,0.0,0,0.0
mother_baby,144,3,2,0.666666666667,1.0,0,0.0,2,0.666666666667
mother_baby,145,1,0,0.0,NULL,0,0.0,0,0.0
mother_baby,146,2,0,0.0,NULL,0,0.0,0,0.0
mother_baby,147,2,0,0.0,NULL,0,0.0,0,0.0
mother_baby,148,3,0,0.0,NULL,0,0.0,0,0.0
mother_baby,149,3,1,0.333333333333,0.0,1,0.333333333333,0,0.0
mother_baby,150,1,0,0.0,NULL,0,0.0,0,0.0
mother_baby,152,5,0,0.0,NULL,0,0.0,0,0.0
mother_baby,153,4,0,0.0,NULL,0,0.0,0,0.0
mother_baby,154,1,0,0.0,NULL,0,0.0,0,0.0
mother_baby,156,4,0,0.0,NULL,0,0.0,0,0.0
mother_baby,157,1,0,0.0,NULL,0,0.0,0,0.0
mother_baby,158,1,0,0.0,NULL,0,0.0,0,0.0
mother_baby,159,3,0,0.0,NULL,0,0.0,0,0.0
mother_baby,160,1,0,0.0,NULL,0,0.0,0,0.0
mother_baby,161,1,0,0.0,NULL,0,0.0,0,0.0
mother_baby,162,1,0,0.0,NULL,0,0.0,0,0.0
mother_baby,163,1,0,0.0,NULL,0,0.0,0,0.0
mother_baby,165,2,1,0.5,1.0,0,0.0,1,0.5
mother_baby,166,2,0,0.0,NULL,0,0.0,0,0.0
mother_baby,167,3,0,0.0,NULL,0,0.0,0,0.0
mother_baby,168,2,0,0.0,NULL,0,0.0,0,0.0
mother_baby,171,4,1,0.25,1.0,0,0.0,1,0.25
mother_baby,172,1,0,0.0,NULL,0,0.0,0,0.0
mother_baby,173,1,0,0.0,NULL,0,0.0,0,0.0
mother_baby,174,1,0,0.0,NULL,0,0.0,0,0.0
mother_baby,175,1,0,0.0,NULL,0,0.0,0,0.0
mother_baby,176,1,0,0.0,NULL,0,0.0,0,0.0
mother_baby,177,1,0,0.0,NULL,0,0.0,0,0.0
mother_baby,178,1,0,0.0,NULL,0,0.0,0,0.0
mother_baby,179,1,0,0.0,NULL,0,0.0,0,0.0
mother_baby,180,2,0,0.0,NULL,0,0.0,0,0.0
mother_baby,182,1,0,0.0,NULL,0,0.0,0,0.0
mother_baby,186,2,0,0.0,NULL,0,0.0,0,0.0
mother_baby,188,2,0,0.0,NULL,0,0.0,0,0.0
mother_baby,190,1,0,0.0,NULL,0,0.0,0,0.0
mother_baby,192,1,0,0.0,NULL,0,0.0,0,0.0
mother_baby,196,3,0,0.0,NULL,0,0.0,0,0.0
mother_baby,197,1,0,0.0,NULL,0,0.0,0,0.0
mother_baby,199,2,0,0.0,NULL,0,0.0,0,0.0
mother_baby,202,1,0,0.0,NULL,0,0.0,0,0.0
mother_baby,203,1,0,0.0,NULL,0,0.0,0,0.0
mother_baby,206,3,0,0.0,NULL,0,0.0,0,0.0
mother_baby,208,1,0,0.0,NULL,0,0.0,0,0.0
mother_baby,209,5,0,0.0,NULL,0,0.0,0,0.0
mother_baby,210,1,0,0.0,NULL,0,0.0,0,0.0
mother_baby,211,1,0,0.0,NULL,0,0.0,0,0.0
mother_baby,212,2,1,0.5,0.0,1,0.5,0,0.0
mother_baby,217,1,0,0.0,NULL,0,0.0,0,0.0
mother_baby,219,2,0,0.0,NULL,0,0.0,0,0.0
mother_baby,223,2,0,0.0,NULL,0,0.0,0,0.0
mother_baby,225,1,0,0.0,NULL,0,0.0,0,0.0
mother_baby,230,1,0,0.0,NULL,0,0.0,0,0.0
mother_baby,234,1,0,0.0,NULL,0,0.0,0,0.0
mother_baby,245,1,0,0.0,NULL,0,0.0,0,0.0
mother_baby,246,1,0,0.0,NULL,0,0.0,0,0.0
mother_baby,251,1,0,0.0,NULL,0,0.0,0,0.0
mother_baby,253,1,0,0.0,NULL,0,0.0,0,0.0
mother_baby,255,1,1,1.0,0.0,1,1.0,0,0.0
mother_baby,256,1,0,0.0,NULL,0,0.0,0,0.0
mother_baby,267,1,0,0.0,NULL,0,0.0,0,0.0
mother_baby,273,1,0,0.0,NULL,0,0.0,0,0.0
mother_baby,279,1,0,0.0,NULL,0,0.0,0,0.0
mother_baby,285,1,1,1.0,0.0,1,1.0,0,0.0
mother_baby,290,1,0,0.0,NULL,0,0.0,0,0.0
mother_baby,300,1,0,0.0,NULL,0,0.0,0,0.0
mother_baby,309,1,0,0.0,NULL,0,0.0,0,0.0
mother_baby,312,1,0,0.0,NULL,0,0.0,0,0.0
mother_baby,316,1,0,0.0,NULL,0,0.0,0,0.0
mother_baby,317,1,0,0.0,NULL,0,0.0,0,0.0
mother_baby,335,1,0,0.0,NULL,0,0.0,0,0.0
mother_baby,336,1,0,0.0,NULL,0,0.0,0,0.0
mother_baby,338,2,1,0.5,0.0,1,0.5,0,0.0
mother_baby,354,1,0,0.0,NULL,0,0.0,0,0.0
mother_baby,374,1,0,0.0,NULL,0,0.0,0,0.0
mother_baby,375,1,0,0.0,NULL,0,0.0,0,0.0
mother_baby,378,1,0,0.0,NULL,0,0.0,0,0.0
mother_baby,400,1,0,0.0,NULL,0,0.0,0,0.0
mother_baby,409,2,0,0.0,NULL,0,0.0,0,0.0
mother_baby,433,1,0,0.0,NULL,0,0.0,0,0.0
mother_baby,450,1,0,0.0,NULL,0,0.0,0,0.0
mother_baby,464,1,0,0.0,NULL,0,0.0,0,0.0
mother_baby,480,2,1,0.5,0.0,1,0.5,0,0.0
mother_baby,593,1,0,0.0,NULL,0,0.0,0,0.0
mother_baby,632,1,0,0.0,NULL,0,0.0,0,0.0
mother_baby,644,1,0,0.0,NULL,0,0.0,0,0.0
mother_baby,846,1,1,1.0,1.0,0,0.0,1,1.0
mother_baby,861,1,0,0.0,NULL,0,0.0,0,0.0
mother_baby,1244,1,0,0.0,NULL,0,0.0,0,0.0
mother_baby,1323,1,0,0.0,NULL,0,0.0,0,0.0
mother_baby,3632,1,1,1.0,0.0,1,1.0,0,0.0
mother_baby,6449,1,1,1.0,0.0,1,1.0,0,0.0
mother_baby,20929,1,0,0.0,NULL,0,0.0,0,0.0
restaurant,0,4160471,229874,0.0552519173911,0.207726841661,182123,0.0437746110957,47751,0.0114773062954
restaurant,1,987531,80141,0.0811528954534,0.263585430678,59017,0.0597621745545,21124,0.0213907208989
restaurant,2,571828,58241,0.101850556461,0.304991329132,40478,0.0707870198731,17763,0.0310635365879
restaurant,3,350007,40062,0.114460567931,0.333358294643,26707,0.076304188202,13355,0.0381563797295
restaurant,4,254329,32296,0.126985125566,0.352272727273,20919,0.0822517290596,11377,0.0447333965061
restaurant,5,180713,24577,0.136000177076,0.379826667209,15242,0.0843436830776,9335,0.0516564939988
restaurant,6,143532,20612,0.143605607112,0.392538327188,12521,0.0872349023214,8091,0.0563707047906
restaurant,7,109012,16445,0.150854951748,0.408513225905,9727,0.089228708766,6718,0.0616262429824
restaurant,8,91170,14250,0.156301414939,0.410526315789,8400,0.0921355709115,5850,0.0641658440276
restaurant,9,73640,11886,0.161406844106,0.440686521959,6648,0.0902770233569,5238,0.0711298207496
restaurant,10,62918,10347,0.164452144061,0.438484584904,5810,0.0923424139356,4537,0.0721097301249
restaurant,11,52179,8951,0.171544107783,0.449558708524,4927,0.094424960233,4024,0.0771191475498
restaurant,12,46002,7725,0.167927481414,0.454757281553,4212,0.091561236468,3513,0.0763662449459
restaurant,13,38769,6771,0.174649849106,0.476000590755,3548,0.0915164177565,3223,0.0831334313498
restaurant,14,34579,6145,0.177709014142,0.46851098454,3266,0.0944503889644,2879,0.0832586251771
restaurant,15,29897,5330,0.178278757066,0.486679174484,2736,0.091514198749,2594,0.0867645583169
restaurant,16,26843,4868,0.181350817718,0.480690221857,2528,0.0941772529151,2340,0.0871735648027
restaurant,17,23791,4355,0.183052414779,0.475774971297,2283,0.0959606573915,2072,0.0870917573872
restaurant,18,21440,3886,0.18125,0.495110653628,1962,0.0915111940299,1924,0.0897388059701
restaurant,19,19668,3825,0.194478340451,0.46954248366,2029,0.103162497458,1796,0.0913158429937
restaurant,20,17350,3147,0.181383285303,0.50142993327,1569,0.0904322766571,1578,0.0909510086455
restaurant,21,15607,2977,0.190747741398,0.495465233456,1502,0.096238867175,1475,0.0945088742231
restaurant,22,14239,2656,0.186529952946,0.507530120482,1308,0.0918603834539,1348,0.0946695694922
restaurant,23,13025,2394,0.183800383877,0.515873015873,1159,0.0889827255278,1235,0.0948176583493
restaurant,24,11989,2176,0.181499708066,0.507352941176,1072,0.0894152973559,1104,0.0920844107098
restaurant,25,10574,2018,0.190845470021,0.524777006938,959,0.0906941554757,1059,0.100151314545
restaurant,26,9770,1829,0.187205731832,0.521049753964,876,0.0896622313204,953,0.0975435005118
restaurant,27,9036,1734,0.191899070385,0.524221453287,825,0.0913014608234,909,0.100597609562
restaurant,28,8372,1645,0.196488294314,0.528875379939,775,0.0925704730053,870,0.103917821309
restaurant,29,7701,1456,0.189066355019,0.529532967033,685,0.0889494870796,771,0.100116867939
restaurant,30,7230,1366,0.188934993084,0.546852122987,619,0.0856154910097,747,0.103319502075
restaurant,31,6724,1360,0.202260559191,0.541176470588,624,0.0928019036288,736,0.109458655562
restaurant,32,6388,1154,0.180651221039,0.549393414211,520,0.0814026299311,634,0.0992485911083
restaurant,33,5911,1101,0.186262899679,0.538601271571,508,0.0859414650651,593,0.100321434613
restaurant,34,5523,970,0.175629187036,0.555670103093,431,0.0780372985696,539,0.0975918884664
restaurant,35,5080,1044,0.205511811024,0.530651340996,490,0.0964566929134,554,0.10905511811
restaurant,36,4843,923,0.190584348544,0.536294691224,428,0.0883749741896,495,0.102209374355
restaurant,37,4505,867,0.192452830189,0.557093425606,384,0.0852386237514,483,0.107214206437
restaurant,38,4313,835,0.193600741943,0.554491017964,372,0.0862508694644,463,0.107349872479
restaurant,39,3930,775,0.197201017812,0.566451612903,336,0.0854961832061,439,0.111704834606
restaurant,40,3803,758,0.199316329214,0.550131926121,341,0.089666053116,417,0.109650276098
restaurant,41,3605,710,0.196948682386,0.56338028169,310,0.0859916782247,400,0.110957004161
restaurant,42,3437,619,0.18009892348,0.571890145396,265,0.0771021239453,354,0.102996799534
restaurant,43,3144,605,0.192430025445,0.560330578512,266,0.0846055979644,339,0.107824427481
restaurant,44,3013,565,0.187520743445,0.569911504425,243,0.0806505144374,322,0.106870229008
restaurant,45,2862,527,0.184136967156,0.53320683112,246,0.0859538784067,281,0.0981830887491
restaurant,46,2677,534,0.199477026522,0.548689138577,241,0.0900261486739,293,0.109450877848
restaurant,47,2525,484,0.191683168317,0.566115702479,210,0.0831683168317,274,0.108514851485
restaurant,48,2499,439,0.175670268107,0.55125284738,197,0.078831532613,242,0.0968387354942
restaurant,49,2382,453,0.190176322418,0.569536423841,195,0.0818639798489,258,0.108312342569
restaurant,50,2236,391,0.174865831843,0.547314578005,177,0.0791592128801,214,0.0957066189624
restaurant,51,2150,411,0.191162790698,0.554744525547,183,0.0851162790698,228,0.106046511628
restaurant,52,2095,398,0.189976133652,0.565326633166,173,0.0825775656325,225,0.107398568019
restaurant,53,1909,335,0.175484546883,0.507462686567,165,0.0864326872708,170,0.0890518596124
restaurant,54,1803,309,0.171381031614,0.533980582524,144,0.0798668885191,165,0.0915141430948
restaurant,55,1830,297,0.162295081967,0.572390572391,127,0.0693989071038,170,0.0928961748634
restaurant,56,1655,309,0.18670694864,0.559870550162,136,0.0821752265861,173,0.104531722054
restaurant,57,1671,311,0.186116098145,0.549839228296,140,0.0837821663674,171,0.102333931777
restaurant,58,1529,269,0.175931981687,0.53531598513,125,0.0817527795945,144,0.0941792020929
restaurant,59,1408,261,0.185369318182,0.547892720307,118,0.0838068181818,143,0.1015625
restaurant,60,1452,295,0.203168044077,0.542372881356,135,0.0929752066116,160,0.110192837466
restaurant,61,1400,242,0.172857142857,0.644628099174,86,0.0614285714286,156,0.111428571429
restaurant,62,1404,259,0.184472934473,0.598455598456,104,0.0740740740741,155,0.110398860399
restaurant,63,1249,230,0.184147317854,0.517391304348,111,0.0888710968775,119,0.0952762209768
restaurant,64,1225,219,0.178775510204,0.584474885845,91,0.0742857142857,128,0.104489795918
restaurant,65,1155,225,0.194805194805,0.604444444444,89,0.0770562770563,136,0.117748917749
restaurant,66,1138,192,0.168717047452,0.598958333333,77,0.0676625659051,115,0.101054481547
restaurant,67,1038,200,0.19267822736,0.58,84,0.0809248554913,116,0.111753371869
restaurant,68,1036,198,0.19111969112,0.575757575758,84,0.0810810810811,114,0.110038610039
restaurant,69,1032,202,0.195736434109,0.594059405941,82,0.0794573643411,120,0.116279069767
restaurant,70,1042,211,0.202495201536,0.516587677725,102,0.0978886756238,109,0.104606525912
restaurant,71,992,164,0.165322580645,0.560975609756,72,0.0725806451613,92,0.0927419354839
restaurant,72,903,167,0.184939091916,0.610778443114,65,0.0719822812846,102,0.112956810631
restaurant,73,912,166,0.18201754386,0.572289156627,71,0.077850877193,95,0.104166666667
restaurant,74,876,157,0.179223744292,0.579617834395,66,0.0753424657534,91,0.103881278539
restaurant,75,851,183,0.215041128085,0.584699453552,76,0.0893066980024,107,0.125734430082
restaurant,76,785,138,0.175796178344,0.579710144928,58,0.0738853503185,80,0.101910828025
restaurant,77,788,143,0.181472081218,0.51048951049,70,0.0888324873096,73,0.0926395939086
restaurant,78,734,142,0.193460490463,0.633802816901,52,0.0708446866485,90,0.122615803815
restaurant,79,753,122,0.162018592297,0.5,61,0.0810092961487,61,0.0810092961487
restaurant,80,741,132,0.178137651822,0.628787878788,49,0.0661268556005,83,0.112010796221
restaurant,81,756,136,0.179894179894,0.529411764706,64,0.0846560846561,72,0.0952380952381
restaurant,82,659,104,0.157814871017,0.721153846154,29,0.0440060698027,75,0.113808801214
restaurant,83,653,108,0.16539050536,0.592592592593,44,0.0673813169985,64,0.0980091883614
restaurant,84,645,112,0.173643410853,0.678571428571,36,0.0558139534884,76,0.117829457364
restaurant,85,617,96,0.155591572123,0.510416666667,47,0.0761750405186,49,0.0794165316045
restaurant,86,579,91,0.157167530225,0.549450549451,41,0.0708117443869,50,0.0863557858377
restaurant,87,523,94,0.179732313576,0.563829787234,41,0.0783938814532,53,0.101338432122
restaurant,88,529,113,0.213610586011,0.637168141593,41,0.0775047258979,72,0.136105860113
restaurant,89,553,105,0.189873417722,0.628571428571,39,0.0705244122966,66,0.119349005425
restaurant,90,544,115,0.211397058824,0.565217391304,50,0.0919117647059,65,0.119485294118
restaurant,91,471,88,0.186836518047,0.579545454545,37,0.0785562632696,51,0.108280254777
restaurant,92,483,95,0.1966873706,0.652631578947,33,0.0683229813665,62,0.128364389234
restaurant,93,489,106,0.216768916155,0.61320754717,41,0.0838445807771,65,0.132924335378
restaurant,94,460,83,0.180434782609,0.530120481928,39,0.0847826086957,44,0.095652173913
restaurant,95,429,75,0.174825174825,0.613333333333,29,0.0675990675991,46,0.107226107226
restaurant,96,455,76,0.167032967033,0.552631578947,34,0.0747252747253,42,0.0923076923077
restaurant,97,435,95,0.218390804598,0.621052631579,36,0.0827586206897,59,0.135632183908
restaurant,98,389,63,0.161953727506,0.555555555556,28,0.0719794344473,35,0.0899742930591
restaurant,99,389,82,0.210796915167,0.548780487805,37,0.0951156812339,45,0.115681233933
restaurant,100,436,85,0.19495412844,0.611764705882,33,0.0756880733945,52,0.119266055046
restaurant,101,386,56,0.145077720207,0.482142857143,29,0.0751295336788,27,0.0699481865285
restaurant,102,361,70,0.193905817175,0.685714285714,22,0.0609418282548,48,0.13296398892
restaurant,103,369,58,0.157181571816,0.586206896552,24,0.0650406504065,34,0.0921409214092
restaurant,104,316,68,0.215189873418,0.544117647059,31,0.0981012658228,37,0.117088607595
restaurant,105,364,65,0.178571428571,0.523076923077,31,0.0851648351648,34,0.0934065934066
restaurant,106,363,70,0.192837465565,0.642857142857,25,0.068870523416,45,0.123966942149
restaurant,107,331,52,0.157099697885,0.519230769231,25,0.0755287009063,27,0.0815709969789
restaurant,108,332,67,0.201807228916,0.537313432836,31,0.0933734939759,36,0.10843373494
restaurant,109,317,60,0.18927444795,0.533333333333,28,0.0883280757098,32,0.10094637224
restaurant,110,321,60,0.18691588785,0.516666666667,29,0.0903426791277,31,0.0965732087227
restaurant,111,282,49,0.173758865248,0.632653061224,18,0.063829787234,31,0.109929078014
restaurant,112,298,47,0.157718120805,0.553191489362,21,0.0704697986577,26,0.0872483221477
restaurant,113,263,34,0.12927756654,0.323529411765,23,0.0874524714829,11,0.041825095057
restaurant,114,256,38,0.1484375,0.605263157895,15,0.05859375,23,0.08984375
restaurant,115,265,43,0.162264150943,0.558139534884,19,0.0716981132075,24,0.0905660377358
restaurant,116,243,42,0.172839506173,0.52380952381,20,0.082304526749,22,0.0905349794239
restaurant,117,285,47,0.164912280702,0.510638297872,23,0.080701754386,24,0.0842105263158
restaurant,118,264,47,0.17803030303,0.702127659574,14,0.0530303030303,33,0.125
restaurant,119,256,35,0.13671875,0.542857142857,16,0.0625,19,0.07421875
restaurant,120,255,45,0.176470588235,0.555555555556,20,0.078431372549,25,0.0980392156863
restaurant,121,241,44,0.182572614108,0.613636363636,17,0.0705394190871,27,0.112033195021
restaurant,122,225,37,0.164444444444,0.621621621622,14,0.0622222222222,23,0.102222222222
restaurant,123,254,36,0.141732283465,0.638888888889,13,0.0511811023622,23,0.0905511811024
restaurant,124,212,34,0.160377358491,0.5,17,0.0801886792453,17,0.0801886792453
restaurant,125,248,36,0.145161290323,0.583333333333,15,0.0604838709677,21,0.0846774193548
restaurant,126,224,25,0.111607142857,0.68,8,0.0357142857143,17,0.0758928571429
restaurant,127,202,27,0.133663366337,0.851851851852,4,0.019801980198,23,0.113861386139
restaurant,128,214,38,0.177570093458,0.342105263158,25,0.116822429907,13,0.0607476635514
restaurant,129,229,43,0.187772925764,0.46511627907,23,0.100436681223,20,0.0873362445415
restaurant,130,195,39,0.2,0.538461538462,18,0.0923076923077,21,0.107692307692
restaurant,131,203,36,0.177339901478,0.583333333333,15,0.0738916256158,21,0.103448275862
restaurant,132,209,42,0.200956937799,0.642857142857,15,0.0717703349282,27,0.129186602871
restaurant,133,203,32,0.15763546798,0.5625,14,0.0689655172414,18,0.0886699507389
restaurant,134,207,35,0.169082125604,0.6,14,0.0676328502415,21,0.101449275362
restaurant,135,195,36,0.184615384615,0.5,18,0.0923076923077,18,0.0923076923077
restaurant,136,190,31,0.163157894737,0.548387096774,14,0.0736842105263,17,0.0894736842105
restaurant,137,165,31,0.187878787879,0.58064516129,13,0.0787878787879,18,0.109090909091
restaurant,138,177,31,0.175141242938,0.41935483871,18,0.101694915254,13,0.0734463276836
restaurant,139,173,31,0.179190751445,0.548387096774,14,0.0809248554913,17,0.0982658959538
restaurant,140,179,32,0.178770949721,0.5,16,0.0893854748603,16,0.0893854748603
restaurant,141,165,31,0.187878787879,0.58064516129,13,0.0787878787879,18,0.109090909091
restaurant,142,148,31,0.209459459459,0.483870967742,16,0.108108108108,15,0.101351351351
restaurant,143,170,34,0.2,0.647058823529,12,0.0705882352941,22,0.129411764706
restaurant,144,155,29,0.187096774194,0.862068965517,4,0.0258064516129,25,0.161290322581
restaurant,145,161,18,0.111801242236,0.611111111111,7,0.0434782608696,11,0.0683229813665
restaurant,146,160,27,0.16875,0.481481481481,14,0.0875,13,0.08125
restaurant,147,130,25,0.192307692308,0.64,9,0.0692307692308,16,0.123076923077
restaurant,148,162,25,0.154320987654,0.8,5,0.0308641975309,20,0.123456790123
restaurant,149,131,19,0.145038167939,0.684210526316,6,0.0458015267176,13,0.0992366412214
restaurant,150,155,37,0.238709677419,0.675675675676,12,0.0774193548387,25,0.161290322581
restaurant,151,148,33,0.222972972973,0.666666666667,11,0.0743243243243,22,0.148648648649
restaurant,152,135,20,0.148148148148,0.55,9,0.0666666666667,11,0.0814814814815
restaurant,153,118,29,0.245762711864,0.620689655172,11,0.0932203389831,18,0.152542372881
restaurant,154,137,28,0.204379562044,0.535714285714,13,0.0948905109489,15,0.109489051095
restaurant,155,124,16,0.129032258065,0.5,8,0.0645161290323,8,0.0645161290323
restaurant,156,148,27,0.182432432432,0.666666666667,9,0.0608108108108,18,0.121621621622
restaurant,157,127,25,0.196850393701,0.6,10,0.0787401574803,15,0.11811023622
restaurant,158,103,11,0.106796116505,0.636363636364,4,0.0388349514563,7,0.0679611650485
restaurant,159,127,22,0.173228346457,0.454545454545,12,0.0944881889764,10,0.0787401574803
restaurant,160,125,13,0.104,0.461538461538,7,0.056,6,0.048
restaurant,161,123,19,0.154471544715,0.473684210526,10,0.0813008130081,9,0.0731707317073
restaurant,162,104,21,0.201923076923,0.333333333333,14,0.134615384615,7,0.0673076923077
restaurant,163,113,19,0.16814159292,0.736842105263,5,0.0442477876106,14,0.12389380531
restaurant,164,106,15,0.141509433962,0.666666666667,5,0.0471698113208,10,0.0943396226415
restaurant,165,124,22,0.177419354839,0.681818181818,7,0.0564516129032,15,0.120967741935
restaurant,166,98,15,0.15306122449,0.666666666667,5,0.0510204081633,10,0.102040816327
restaurant,167,78,9,0.115384615385,0.444444444444,5,0.0641025641026,4,0.0512820512821
restaurant,168,110,17,0.154545454545,0.647058823529,6,0.0545454545455,11,0.1
restaurant,169,95,14,0.147368421053,0.571428571429,6,0.0631578947368,8,0.0842105263158
restaurant,170,118,18,0.152542372881,0.777777777778,4,0.0338983050847,14,0.118644067797
restaurant,171,95,11,0.115789473684,0.545454545455,5,0.0526315789474,6,0.0631578947368
restaurant,172,105,23,0.219047619048,0.652173913043,8,0.0761904761905,15,0.142857142857
restaurant,173,92,12,0.130434782609,0.416666666667,7,0.0760869565217,5,0.054347826087
restaurant,174,92,20,0.217391304348,0.45,11,0.119565217391,9,0.0978260869565
restaurant,175,76,18,0.236842105263,0.722222222222,5,0.0657894736842,13,0.171052631579
restaurant,176,85,15,0.176470588235,0.533333333333,7,0.0823529411765,8,0.0941176470588
restaurant,177,90,13,0.144444444444,0.692307692308,4,0.0444444444444,9,0.1
restaurant,178,85,15,0.176470588235,0.533333333333,7,0.0823529411765,8,0.0941176470588
restaurant,179,85,13,0.152941176471,0.538461538462,6,0.0705882352941,7,0.0823529411765
restaurant,180,90,13,0.144444444444,0.769230769231,3,0.0333333333333,10,0.111111111111
restaurant,181,88,12,0.136363636364,0.75,3,0.0340909090909,9,0.102272727273
restaurant,182,85,13,0.152941176471,0.769230769231,3,0.0352941176471,10,0.117647058824
restaurant,183,86,10,0.116279069767,0.6,4,0.046511627907,6,0.0697674418605
restaurant,184,94,12,0.127659574468,0.583333333333,5,0.0531914893617,7,0.0744680851064
restaurant,185,84,9,0.107142857143,0.444444444444,5,0.0595238095238,4,0.047619047619
restaurant,186,72,16,0.222222222222,0.5625,7,0.0972222222222,9,0.125
restaurant,187,79,17,0.215189873418,0.647058823529,6,0.0759493670886,11,0.139240506329
restaurant,188,79,7,0.0886075949367,0.714285714286,2,0.0253164556962,5,0.0632911392405
restaurant,189,82,10,0.121951219512,0.6,4,0.0487804878049,6,0.0731707317073
restaurant,190,69,11,0.159420289855,0.454545454545,6,0.0869565217391,5,0.0724637681159
restaurant,191,73,11,0.150684931507,0.545454545455,5,0.0684931506849,6,0.0821917808219
restaurant,192,78,11,0.141025641026,0.454545454545,6,0.0769230769231,5,0.0641025641026
restaurant,193,78,14,0.179487179487,0.5,7,0.0897435897436,7,0.0897435897436
restaurant,194,79,14,0.177215189873,0.642857142857,5,0.0632911392405,9,0.113924050633
restaurant,195,65,8,0.123076923077,0.75,2,0.0307692307692,6,0.0923076923077
restaurant,196,72,7,0.0972222222222,0.857142857143,1,0.0138888888889,6,0.0833333333333
restaurant,197,54,12,0.222222222222,0.666666666667,4,0.0740740740741,8,0.148148148148
restaurant,198,60,9,0.15,0.444444444444,5,0.0833333333333,4,0.0666666666667
restaurant,199,68,12,0.176470588235,0.5,6,0.0882352941176,6,0.0882352941176
restaurant,200,64,4,0.0625,0.5,2,0.03125,2,0.03125
restaurant,201,55,8,0.145454545455,0.875,1,0.0181818181818,7,0.127272727273
restaurant,202,57,4,0.0701754385965,0.5,2,0.0350877192982,2,0.0350877192982
restaurant,203,63,4,0.0634920634921,0.25,3,0.047619047619,1,0.015873015873
restaurant,204,73,9,0.123287671233,1.0,0,0.0,9,0.123287671233
restaurant,205,62,8,0.129032258065,0.625,3,0.0483870967742,5,0.0806451612903
restaurant,206,65,8,0.123076923077,0.5,4,0.0615384615385,4,0.0615384615385
restaurant,207,36,3,0.0833333333333,1.0,0,0.0,3,0.0833333333333
restaurant,208,55,15,0.272727272727,0.666666666667,5,0.0909090909091,10,0.181818181818
restaurant,209,55,4,0.0727272727273,0.25,3,0.0545454545455,1,0.0181818181818
restaurant,210,60,12,0.2,0.5,6,0.1,6,0.1
restaurant,211,46,7,0.152173913043,0.714285714286,2,0.0434782608696,5,0.108695652174
restaurant,212,54,11,0.203703703704,0.636363636364,4,0.0740740740741,7,0.12962962963
restaurant,213,56,10,0.178571428571,0.6,4,0.0714285714286,6,0.107142857143
restaurant,214,51,6,0.117647058824,0.333333333333,4,0.078431372549,2,0.0392156862745
restaurant,215,53,11,0.207547169811,0.454545454545,6,0.11320754717,5,0.0943396226415
restaurant,216,54,9,0.166666666667,0.777777777778,2,0.037037037037,7,0.12962962963
restaurant,217,50,11,0.22,0.636363636364,4,0.08,7,0.14
restaurant,218,62,10,0.161290322581,0.6,4,0.0645161290323,6,0.0967741935484
restaurant,219,62,11,0.177419354839,0.454545454545,6,0.0967741935484,5,0.0806451612903
restaurant,220,56,12,0.214285714286,0.583333333333,5,0.0892857142857,7,0.125
restaurant,221,49,8,0.163265306122,0.625,3,0.0612244897959,5,0.102040816327
restaurant,222,39,8,0.205128205128,0.625,3,0.0769230769231,5,0.128205128205
restaurant,223,41,7,0.170731707317,0.285714285714,5,0.121951219512,2,0.0487804878049
restaurant,224,50,10,0.2,0.3,7,0.14,3,0.06
restaurant,225,36,8,0.222222222222,0.625,3,0.0833333333333,5,0.138888888889
restaurant,226,48,13,0.270833333333,0.538461538462,6,0.125,7,0.145833333333
restaurant,227,38,7,0.184210526316,0.714285714286,2,0.0526315789474,5,0.131578947368
restaurant,228,41,9,0.219512195122,0.555555555556,4,0.0975609756098,5,0.121951219512
restaurant,229,37,3,0.0810810810811,1.0,0,0.0,3,0.0810810810811
restaurant,230,41,5,0.121951219512,0.6,2,0.0487804878049,3,0.0731707317073
restaurant,231,41,8,0.19512195122,0.625,3,0.0731707317073,5,0.121951219512
restaurant,232,37,7,0.189189189189,0.571428571429,3,0.0810810810811,4,0.108108108108
restaurant,233,36,3,0.0833333333333,0.666666666667,1,0.0277777777778,2,0.0555555555556
restaurant,234,41,8,0.19512195122,0.625,3,0.0731707317073,5,0.121951219512
restaurant,235,42,4,0.0952380952381,0.5,2,0.047619047619,2,0.047619047619
restaurant,236,26,1,0.0384615384615,0.0,1,0.0384615384615,0,0.0
restaurant,237,38,7,0.184210526316,0.714285714286,2,0.0526315789474,5,0.131578947368
restaurant,238,38,2,0.0526315789474,0.5,1,0.0263157894737,1,0.0263157894737
restaurant,239,35,5,0.142857142857,0.6,2,0.0571428571429,3,0.0857142857143
restaurant,240,50,11,0.22,0.727272727273,3,0.06,8,0.16
restaurant,241,42,5,0.119047619048,0.4,3,0.0714285714286,2,0.047619047619
restaurant,242,30,3,0.1,1.0,0,0.0,3,0.1
restaurant,243,42,6,0.142857142857,0.666666666667,2,0.047619047619,4,0.0952380952381
restaurant,244,40,7,0.175,0.571428571429,3,0.075,4,0.1
restaurant,245,38,7,0.184210526316,0.285714285714,5,0.131578947368,2,0.0526315789474
restaurant,246,28,4,0.142857142857,0.25,3,0.107142857143,1,0.0357142857143
restaurant,247,30,3,0.1,0.333333333333,2,0.0666666666667,1,0.0333333333333
restaurant,248,31,5,0.161290322581,0.6,2,0.0645161290323,3,0.0967741935484
restaurant,249,39,6,0.153846153846,0.333333333333,4,0.102564102564,2,0.0512820512821
restaurant,250,40,2,0.05,0.5,1,0.025,1,0.025
restaurant,251,26,6,0.230769230769,0.5,3,0.115384615385,3,0.115384615385
restaurant,252,45,3,0.0666666666667,0.666666666667,1,0.0222222222222,2,0.0444444444444
restaurant,253,27,5,0.185185185185,0.8,1,0.037037037037,4,0.148148148148
restaurant,254,39,7,0.179487179487,0.571428571429,3,0.0769230769231,4,0.102564102564
restaurant,255,30,4,0.133333333333,0.75,1,0.0333333333333,3,0.1
restaurant,256,24,3,0.125,1.0,0,0.0,3,0.125
restaurant,257,33,4,0.121212121212,1.0,0,0.0,4,0.121212121212
restaurant,258,28,3,0.107142857143,1.0,0,0.0,3,0.107142857143
restaurant,259,33,6,0.181818181818,0.833333333333,1,0.030303030303,5,0.151515151515
restaurant,260,42,6,0.142857142857,0.833333333333,1,0.0238095238095,5,0.119047619048
restaurant,261,30,3,0.1,0.666666666667,1,0.0333333333333,2,0.0666666666667
restaurant,262,35,8,0.228571428571,0.5,4,0.114285714286,4,0.114285714286
restaurant,263,37,8,0.216216216216,0.625,3,0.0810810810811,5,0.135135135135
restaurant,264,33,5,0.151515151515,0.8,1,0.030303030303,4,0.121212121212
restaurant,265,29,6,0.206896551724,0.5,3,0.103448275862,3,0.103448275862
restaurant,266,34,5,0.147058823529,0.2,4,0.117647058824,1,0.0294117647059
restaurant,267,27,3,0.111111111111,0.666666666667,1,0.037037037037,2,0.0740740740741
restaurant,268,20,2,0.1,0.5,1,0.05,1,0.05
restaurant,269,20,2,0.1,0.0,2,0.1,0,0.0
restaurant,270,40,8,0.2,0.75,2,0.05,6,0.15
restaurant,271,31,10,0.322580645161,0.4,6,0.193548387097,4,0.129032258065
restaurant,272,29,3,0.103448275862,0.666666666667,1,0.0344827586207,2,0.0689655172414
restaurant,273,33,8,0.242424242424,0.5,4,0.121212121212,4,0.121212121212
restaurant,274,20,3,0.15,0.666666666667,1,0.05,2,0.1
restaurant,275,16,0,0.0,NULL,0,0.0,0,0.0
restaurant,276,29,5,0.172413793103,0.6,2,0.0689655172414,3,0.103448275862
restaurant,277,34,7,0.205882352941,0.857142857143,1,0.0294117647059,6,0.176470588235
restaurant,278,35,6,0.171428571429,0.5,3,0.0857142857143,3,0.0857142857143
restaurant,279,28,5,0.178571428571,0.6,2,0.0714285714286,3,0.107142857143
restaurant,280,23,2,0.0869565217391,1.0,0,0.0,2,0.0869565217391
restaurant,281,18,1,0.0555555555556,0.0,1,0.0555555555556,0,0.0
restaurant,282,25,5,0.2,0.8,1,0.04,4,0.16
restaurant,283,24,2,0.0833333333333,0.0,2,0.0833333333333,0,0.0
restaurant,284,23,2,0.0869565217391,0.5,1,0.0434782608696,1,0.0434782608696
restaurant,285,26,7,0.269230769231,0.428571428571,4,0.153846153846,3,0.115384615385
restaurant,286,25,2,0.08,0.5,1,0.04,1,0.04
restaurant,287,21,6,0.285714285714,0.666666666667,2,0.0952380952381,4,0.190476190476
restaurant,288,36,6,0.166666666667,0.666666666667,2,0.0555555555556,4,0.111111111111
restaurant,289,24,3,0.125,0.333333333333,2,0.0833333333333,1,0.0416666666667
restaurant,290,14,2,0.142857142857,0.5,1,0.0714285714286,1,0.0714285714286
restaurant,291,13,1,0.0769230769231,1.0,0,0.0,1,0.0769230769231
restaurant,292,23,5,0.217391304348,0.6,2,0.0869565217391,3,0.130434782609
restaurant,293,26,6,0.230769230769,0.166666666667,5,0.192307692308,1,0.0384615384615
restaurant,294,24,2,0.0833333333333,1.0,0,0.0,2,0.0833333333333
restaurant,295,23,3,0.130434782609,1.0,0,0.0,3,0.130434782609
restaurant,296,22,4,0.181818181818,0.5,2,0.0909090909091,2,0.0909090909091
restaurant,297,16,1,0.0625,0.0,1,0.0625,0,0.0
restaurant,298,25,3,0.12,0.333333333333,2,0.08,1,0.04
restaurant,299,27,4,0.148148148148,0.5,2,0.0740740740741,2,0.0740740740741
restaurant,300,24,3,0.125,0.666666666667,1,0.0416666666667,2,0.0833333333333
restaurant,301,18,2,0.111111111111,1.0,0,0.0,2,0.111111111111
restaurant,302,22,2,0.0909090909091,0.0,2,0.0909090909091,0,0.0
restaurant,303,17,5,0.294117647059,0.6,2,0.117647058824,3,0.176470588235
restaurant,304,17,4,0.235294117647,0.75,1,0.0588235294118,3,0.176470588235
restaurant,305,20,6,0.3,0.5,3,0.15,3,0.15
restaurant,306,17,3,0.176470588235,0.666666666667,1,0.0588235294118,2,0.117647058824
restaurant,307,25,4,0.16,0.25,3,0.12,1,0.04
restaurant,308,15,0,0.0,NULL,0,0.0,0,0.0
restaurant,309,21,4,0.190476190476,0.5,2,0.0952380952381,2,0.0952380952381
restaurant,310,12,1,0.0833333333333,0.0,1,0.0833333333333,0,0.0
restaurant,311,18,6,0.333333333333,0.5,3,0.166666666667,3,0.166666666667
restaurant,312,18,1,0.0555555555556,1.0,0,0.0,1,0.0555555555556
restaurant,313,15,3,0.2,0.666666666667,1,0.0666666666667,2,0.133333333333
restaurant,314,22,4,0.181818181818,1.0,0,0.0,4,0.181818181818
restaurant,315,23,3,0.130434782609,0.666666666667,1,0.0434782608696,2,0.0869565217391
restaurant,316,18,2,0.111111111111,0.5,1,0.0555555555556,1,0.0555555555556
restaurant,317,18,4,0.222222222222,0.5,2,0.111111111111,2,0.111111111111
restaurant,318,22,2,0.0909090909091,0.5,1,0.0454545454545,1,0.0454545454545
restaurant,319,15,1,0.0666666666667,1.0,0,0.0,1,0.0666666666667
restaurant,320,14,2,0.142857142857,0.5,1,0.0714285714286,1,0.0714285714286
restaurant,321,19,2,0.105263157895,0.5,1,0.0526315789474,1,0.0526315789474
restaurant,322,15,2,0.133333333333,0.5,1,0.0666666666667,1,0.0666666666667
restaurant,323,28,0,0.0,NULL,0,0.0,0,0.0
restaurant,324,15,3,0.2,0.333333333333,2,0.133333333333,1,0.0666666666667
restaurant,325,12,1,0.0833333333333,0.0,1,0.0833333333333,0,0.0
restaurant,326,15,1,0.0666666666667,1.0,0,0.0,1,0.0666666666667
restaurant,327,21,3,0.142857142857,0.333333333333,2,0.0952380952381,1,0.047619047619
restaurant,328,14,3,0.214285714286,1.0,0,0.0,3,0.214285714286
restaurant,329,11,4,0.363636363636,0.75,1,0.0909090909091,3,0.272727272727
restaurant,330,14,4,0.285714285714,0.5,2,0.142857142857,2,0.142857142857
restaurant,331,11,0,0.0,NULL,0,0.0,0,0.0
restaurant,332,21,4,0.190476190476,0.5,2,0.0952380952381,2,0.0952380952381
restaurant,333,18,1,0.0555555555556,1.0,0,0.0,1,0.0555555555556
restaurant,334,7,1,0.142857142857,1.0,0,0.0,1,0.142857142857
restaurant,335,13,2,0.153846153846,0.5,1,0.0769230769231,1,0.0769230769231
restaurant,336,13,1,0.0769230769231,0.0,1,0.0769230769231,0,0.0
restaurant,337,13,2,0.153846153846,1.0,0,0.0,2,0.153846153846
restaurant,338,9,2,0.222222222222,0.5,1,0.111111111111,1,0.111111111111
restaurant,339,24,2,0.0833333333333,0.5,1,0.0416666666667,1,0.0416666666667
restaurant,340,20,5,0.25,0.6,2,0.1,3,0.15
restaurant,341,11,1,0.0909090909091,0.0,1,0.0909090909091,0,0.0
restaurant,342,17,2,0.117647058824,0.5,1,0.0588235294118,1,0.0588235294118
restaurant,343,15,0,0.0,NULL,0,0.0,0,0.0
restaurant,344,6,1,0.166666666667,0.0,1,0.166666666667,0,0.0
restaurant,345,19,3,0.157894736842,0.333333333333,2,0.105263157895,1,0.0526315789474
restaurant,346,17,2,0.117647058824,0.5,1,0.0588235294118,1,0.0588235294118
restaurant,347,13,4,0.307692307692,0.25,3,0.230769230769,1,0.0769230769231
restaurant,348,11,2,0.181818181818,1.0,0,0.0,2,0.181818181818
restaurant,349,23,3,0.130434782609,0.333333333333,2,0.0869565217391,1,0.0434782608696
restaurant,350,17,2,0.117647058824,1.0,0,0.0,2,0.117647058824
restaurant,351,9,1,0.111111111111,1.0,0,0.0,1,0.111111111111
restaurant,352,17,3,0.176470588235,0.333333333333,2,0.117647058824,1,0.0588235294118
restaurant,353,13,1,0.0769230769231,0.0,1,0.0769230769231,0,0.0
restaurant,354,13,3,0.230769230769,0.666666666667,1,0.0769230769231,2,0.153846153846
restaurant,355,16,2,0.125,0.5,1,0.0625,1,0.0625
restaurant,356,13,5,0.384615384615,0.6,2,0.153846153846,3,0.230769230769
restaurant,357,13,2,0.153846153846,0.5,1,0.0769230769231,1,0.0769230769231
restaurant,358,8,2,0.25,1.0,0,0.0,2,0.25
restaurant,359,7,3,0.428571428571,0.666666666667,1,0.142857142857,2,0.285714285714
restaurant,360,14,4,0.285714285714,0.0,4,0.285714285714,0,0.0
restaurant,361,14,1,0.0714285714286,1.0,0,0.0,1,0.0714285714286
restaurant,362,18,3,0.166666666667,0.333333333333,2,0.111111111111,1,0.0555555555556
restaurant,363,13,3,0.230769230769,1.0,0,0.0,3,0.230769230769
restaurant,364,12,0,0.0,NULL,0,0.0,0,0.0
restaurant,365,13,1,0.0769230769231,1.0,0,0.0,1,0.0769230769231
restaurant,366,9,2,0.222222222222,0.5,1,0.111111111111,1,0.111111111111
restaurant,367,7,0,0.0,NULL,0,0.0,0,0.0
restaurant,368,6,2,0.333333333333,0.5,1,0.166666666667,1,0.166666666667
restaurant,369,16,1,0.0625,0.0,1,0.0625,0,0.0
restaurant,370,11,2,0.181818181818,0.5,1,0.0909090909091,1,0.0909090909091
restaurant,371,11,3,0.272727272727,0.666666666667,1,0.0909090909091,2,0.181818181818
restaurant,372,10,1,0.1,1.0,0,0.0,1,0.1
restaurant,373,15,4,0.266666666667,0.75,1,0.0666666666667,3,0.2
restaurant,374,11,0,0.0,NULL,0,0.0,0,0.0
restaurant,375,8,2,0.25,1.0,0,0.0,2,0.25
restaurant,376,4,0,0.0,NULL,0,0.0,0,0.0
restaurant,377,10,3,0.3,0.333333333333,2,0.2,1,0.1
restaurant,378,14,2,0.142857142857,0.0,2,0.142857142857,0,0.0
restaurant,379,9,1,0.111111111111,1.0,0,0.0,1,0.111111111111
restaurant,380,11,2,0.181818181818,0.0,2,0.181818181818,0,0.0
restaurant,381,12,2,0.166666666667,0.5,1,0.0833333333333,1,0.0833333333333
restaurant,382,14,1,0.0714285714286,0.0,1,0.0714285714286,0,0.0
restaurant,383,14,3,0.214285714286,0.666666666667,1,0.0714285714286,2,0.142857142857
restaurant,384,10,0,0.0,NULL,0,0.0,0,0.0
restaurant,385,15,3,0.2,0.333333333333,2,0.133333333333,1,0.0666666666667
restaurant,386,10,1,0.1,1.0,0,0.0,1,0.1
restaurant,387,11,3,0.272727272727,0.333333333333,2,0.181818181818,1,0.0909090909091
restaurant,388,7,0,0.0,NULL,0,0.0,0,0.0
restaurant,389,15,4,0.266666666667,0.75,1,0.0666666666667,3,0.2
restaurant,390,9,4,0.444444444444,0.5,2,0.222222222222,2,0.222222222222
restaurant,391,8,0,0.0,NULL,0,0.0,0,0.0
restaurant,392,10,2,0.2,0.5,1,0.1,1,0.1
restaurant,393,7,0,0.0,NULL,0,0.0,0,0.0
restaurant,394,6,1,0.166666666667,0.0,1,0.166666666667,0,0.0
restaurant,395,13,3,0.230769230769,0.666666666667,1,0.0769230769231,2,0.153846153846
restaurant,396,8,2,0.25,0.5,1,0.125,1,0.125
restaurant,397,14,2,0.142857142857,1.0,0,0.0,2,0.142857142857
restaurant,398,9,1,0.111111111111,0.0,1,0.111111111111,0,0.0
restaurant,399,8,1,0.125,1.0,0,0.0,1,0.125
restaurant,400,6,2,0.333333333333,0.5,1,0.166666666667,1,0.166666666667
restaurant,401,5,0,0.0,NULL,0,0.0,0,0.0
restaurant,402,12,0,0.0,NULL,0,0.0,0,0.0
restaurant,403,7,0,0.0,NULL,0,0.0,0,0.0
restaurant,404,11,2,0.181818181818,0.5,1,0.0909090909091,1,0.0909090909091
restaurant,405,13,0,0.0,NULL,0,0.0,0,0.0
restaurant,406,14,1,0.0714285714286,1.0,0,0.0,1,0.0714285714286
restaurant,407,9,0,0.0,NULL,0,0.0,0,0.0
restaurant,408,8,0,0.0,NULL,0,0.0,0,0.0
restaurant,409,12,1,0.0833333333333,1.0,0,0.0,1,0.0833333333333
restaurant,410,12,0,0.0,NULL,0,0.0,0,0.0
restaurant,411,3,1,0.333333333333,0.0,1,0.333333333333,0,0.0
restaurant,412,14,1,0.0714285714286,0.0,1,0.0714285714286,0,0.0
restaurant,413,3,0,0.0,NULL,0,0.0,0,0.0
restaurant,414,11,1,0.0909090909091,0.0,1,0.0909090909091,0,0.0
restaurant,415,12,3,0.25,0.333333333333,2,0.166666666667,1,0.0833333333333
restaurant,416,11,3,0.272727272727,0.666666666667,1,0.0909090909091,2,0.181818181818
restaurant,417,9,2,0.222222222222,1.0,0,0.0,2,0.222222222222
restaurant,418,7,1,0.142857142857,1.0,0,0.0,1,0.142857142857
restaurant,419,15,3,0.2,1.0,0,0.0,3,0.2
restaurant,420,12,2,0.166666666667,0.5,1,0.0833333333333,1,0.0833333333333
restaurant,421,6,1,0.166666666667,0.0,1,0.166666666667,0,0.0
restaurant,422,9,1,0.111111111111,0.0,1,0.111111111111,0,0.0
restaurant,423,9,1,0.111111111111,0.0,1,0.111111111111,0,0.0
restaurant,424,7,0,0.0,NULL,0,0.0,0,0.0
restaurant,425,11,2,0.181818181818,1.0,0,0.0,2,0.181818181818
restaurant,426,7,0,0.0,NULL,0,0.0,0,0.0
restaurant,427,9,0,0.0,NULL,0,0.0,0,0.0
restaurant,428,8,1,0.125,1.0,0,0.0,1,0.125
restaurant,429,6,1,0.166666666667,1.0,0,0.0,1,0.166666666667
restaurant,430,13,1,0.0769230769231,1.0,0,0.0,1,0.0769230769231
restaurant,431,4,1,0.25,1.0,0,0.0,1,0.25
restaurant,432,10,2,0.2,1.0,0,0.0,2,0.2
restaurant,433,4,0,0.0,NULL,0,0.0,0,0.0
restaurant,434,7,0,0.0,NULL,0,0.0,0,0.0
restaurant,435,6,2,0.333333333333,1.0,0,0.0,2,0.333333333333
restaurant,436,3,1,0.333333333333,0.0,1,0.333333333333,0,0.0
restaurant,437,9,3,0.333333333333,0.666666666667,1,0.111111111111,2,0.222222222222
restaurant,438,4,1,0.25,0.0,1,0.25,0,0.0
restaurant,439,9,1,0.111111111111,1.0,0,0.0,1,0.111111111111
restaurant,440,9,3,0.333333333333,0.666666666667,1,0.111111111111,2,0.222222222222
restaurant,441,4,0,0.0,NULL,0,0.0,0,0.0
restaurant,442,8,1,0.125,0.0,1,0.125,0,0.0
restaurant,443,4,1,0.25,1.0,0,0.0,1,0.25
restaurant,444,13,1,0.0769230769231,0.0,1,0.0769230769231,0,0.0
restaurant,445,8,1,0.125,1.0,0,0.0,1,0.125
restaurant,446,4,0,0.0,NULL,0,0.0,0,0.0
restaurant,447,7,0,0.0,NULL,0,0.0,0,0.0
restaurant,448,9,1,0.111111111111,1.0,0,0.0,1,0.111111111111
restaurant,449,8,4,0.5,0.25,3,0.375,1,0.125
restaurant,450,6,1,0.166666666667,1.0,0,0.0,1,0.166666666667
restaurant,451,6,0,0.0,NULL,0,0.0,0,0.0
restaurant,452,10,0,0.0,NULL,0,0.0,0,0.0
restaurant,453,6,1,0.166666666667,0.0,1,0.166666666667,0,0.0
restaurant,454,7,3,0.428571428571,0.666666666667,1,0.142857142857,2,0.285714285714
restaurant,455,11,1,0.0909090909091,1.0,0,0.0,1,0.0909090909091
restaurant,456,4,0,0.0,NULL,0,0.0,0,0.0
restaurant,457,4,0,0.0,NULL,0,0.0,0,0.0
restaurant,458,4,2,0.5,1.0,0,0.0,2,0.5
restaurant,459,5,1,0.2,1.0,0,0.0,1,0.2
restaurant,460,4,0,0.0,NULL,0,0.0,0,0.0
restaurant,461,4,0,0.0,NULL,0,0.0,0,0.0
restaurant,462,7,0,0.0,NULL,0,0.0,0,0.0
restaurant,463,7,0,0.0,NULL,0,0.0,0,0.0
restaurant,464,3,0,0.0,NULL,0,0.0,0,0.0
restaurant,465,9,1,0.111111111111,1.0,0,0.0,1,0.111111111111
restaurant,466,6,0,0.0,NULL,0,0.0,0,0.0
restaurant,467,7,2,0.285714285714,0.5,1,0.142857142857,1,0.142857142857
restaurant,468,4,0,0.0,NULL,0,0.0,0,0.0
restaurant,469,6,1,0.166666666667,1.0,0,0.0,1,0.166666666667
restaurant,470,8,0,0.0,NULL,0,0.0,0,0.0
restaurant,471,7,3,0.428571428571,0.333333333333,2,0.285714285714,1,0.142857142857
restaurant,472,6,0,0.0,NULL,0,0.0,0,0.0
restaurant,473,5,2,0.4,0.0,2,0.4,0,0.0
restaurant,474,6,0,0.0,NULL,0,0.0,0,0.0
restaurant,475,11,2,0.181818181818,1.0,0,0.0,2,0.181818181818
restaurant,476,5,1,0.2,0.0,1,0.2,0,0.0
restaurant,477,5,0,0.0,NULL,0,0.0,0,0.0
restaurant,478,3,1,0.333333333333,0.0,1,0.333333333333,0,0.0
restaurant,479,5,0,0.0,NULL,0,0.0,0,0.0
restaurant,480,8,4,0.5,1.0,0,0.0,4,0.5
restaurant,481,8,0,0.0,NULL,0,0.0,0,0.0
restaurant,482,8,3,0.375,1.0,0,0.0,3,0.375
restaurant,483,7,0,0.0,NULL,0,0.0,0,0.0
restaurant,484,7,1,0.142857142857,1.0,0,0.0,1,0.142857142857
restaurant,485,3,0,0.0,NULL,0,0.0,0,0.0
restaurant,486,2,0,0.0,NULL,0,0.0,0,0.0
restaurant,487,8,0,0.0,NULL,0,0.0,0,0.0
restaurant,488,2,0,0.0,NULL,0,0.0,0,0.0
restaurant,489,2,1,0.5,1.0,0,0.0,1,0.5
restaurant,490,6,1,0.166666666667,1.0,0,0.0,1,0.166666666667
restaurant,491,5,0,0.0,NULL,0,0.0,0,0.0
restaurant,492,7,1,0.142857142857,1.0,0,0.0,1,0.142857142857
restaurant,493,8,1,0.125,0.0,1,0.125,0,0.0
restaurant,494,6,1,0.166666666667,1.0,0,0.0,1,0.166666666667
restaurant,495,4,1,0.25,0.0,1,0.25,0,0.0
restaurant,496,4,0,0.0,NULL,0,0.0,0,0.0
restaurant,497,4,2,0.5,1.0,0,0.0,2,0.5
restaurant,498,2,0,0.0,NULL,0,0.0,0,0.0
restaurant,499,4,1,0.25,0.0,1,0.25,0,0.0
restaurant,500,2,1,0.5,1.0,0,0.0,1,0.5
restaurant,501,5,1,0.2,0.0,1,0.2,0,0.0
restaurant,502,2,0,0.0,NULL,0,0.0,0,0.0
restaurant,503,3,1,0.333333333333,0.0,1,0.333333333333,0,0.0
restaurant,504,7,0,0.0,NULL,0,0.0,0,0.0
restaurant,505,3,1,0.333333333333,0.0,1,0.333333333333,0,0.0
restaurant,506,3,0,0.0,NULL,0,0.0,0,0.0
restaurant,507,7,1,0.142857142857,1.0,0,0.0,1,0.142857142857
restaurant,508,3,0,0.0,NULL,0,0.0,0,0.0
restaurant,509,3,0,0.0,NULL,0,0.0,0,0.0
restaurant,510,4,0,0.0,NULL,0,0.0,0,0.0
restaurant,511,8,2,0.25,0.5,1,0.125,1,0.125
restaurant,512,4,1,0.25,0.0,1,0.25,0,0.0
restaurant,513,8,0,0.0,NULL,0,0.0,0,0.0
restaurant,514,6,0,0.0,NULL,0,0.0,0,0.0
restaurant,515,2,1,0.5,0.0,1,0.5,0,0.0
restaurant,516,1,0,0.0,NULL,0,0.0,0,0.0
restaurant,517,2,1,0.5,1.0,0,0.0,1,0.5
restaurant,518,4,0,0.0,NULL,0,0.0,0,0.0
restaurant,519,3,1,0.333333333333,0.0,1,0.333333333333,0,0.0
restaurant,520,3,0,0.0,NULL,0,0.0,0,0.0
restaurant,521,4,0,0.0,NULL,0,0.0,0,0.0
restaurant,524,1,0,0.0,NULL,0,0.0,0,0.0
restaurant,525,2,0,0.0,NULL,0,0.0,0,0.0
restaurant,526,2,0,0.0,NULL,0,0.0,0,0.0
restaurant,527,1,1,1.0,0.0,1,1.0,0,0.0
restaurant,528,3,0,0.0,NULL,0,0.0,0,0.0
restaurant,529,3,1,0.333333333333,1.0,0,0.0,1,0.333333333333
restaurant,530,3,0,0.0,NULL,0,0.0,0,0.0
restaurant,531,3,1,0.333333333333,0.0,1,0.333333333333,0,0.0
restaurant,532,2,1,0.5,0.0,1,0.5,0,0.0
restaurant,533,1,0,0.0,NULL,0,0.0,0,0.0
restaurant,534,3,1,0.333333333333,1.0,0,0.0,1,0.333333333333
restaurant,535,3,0,0.0,NULL,0,0.0,0,0.0
restaurant,536,2,0,0.0,NULL,0,0.0,0,0.0
restaurant,537,3,0,0.0,NULL,0,0.0,0,0.0
restaurant,538,4,1,0.25,1.0,0,0.0,1,0.25
restaurant,539,1,0,0.0,NULL,0,0.0,0,0.0
restaurant,540,3,0,0.0,NULL,0,0.0,0,0.0
restaurant,541,6,0,0.0,NULL,0,0.0,0,0.0
restaurant,542,6,0,0.0,NULL,0,0.0,0,0.0
restaurant,543,5,1,0.2,0.0,1,0.2,0,0.0
restaurant,544,5,1,0.2,1.0,0,0.0,1,0.2
restaurant,545,3,0,0.0,NULL,0,0.0,0,0.0
restaurant,546,2,0,0.0,NULL,0,0.0,0,0.0
restaurant,547,6,1,0.166666666667,1.0,0,0.0,1,0.166666666667
restaurant,548,3,1,0.333333333333,1.0,0,0.0,1,0.333333333333
restaurant,549,1,0,0.0,NULL,0,0.0,0,0.0
restaurant,550,3,0,0.0,NULL,0,0.0,0,0.0
restaurant,551,1,0,0.0,NULL,0,0.0,0,0.0
restaurant,552,6,1,0.166666666667,1.0,0,0.0,1,0.166666666667
restaurant,553,1,0,0.0,NULL,0,0.0,0,0.0
restaurant,554,4,0,0.0,NULL,0,0.0,0,0.0
restaurant,555,2,0,0.0,NULL,0,0.0,0,0.0
restaurant,556,1,0,0.0,NULL,0,0.0,0,0.0
restaurant,557,6,1,0.166666666667,0.0,1,0.166666666667,0,0.0
restaurant,558,4,2,0.5,1.0,0,0.0,2,0.5
restaurant,559,9,1,0.111111111111,0.0,1,0.111111111111,0,0.0
restaurant,560,2,1,0.5,0.0,1,0.5,0,0.0
restaurant,561,2,0,0.0,NULL,0,0.0,0,0.0
restaurant,562,6,1,0.166666666667,1.0,0,0.0,1,0.166666666667
restaurant,563,2,0,0.0,NULL,0,0.0,0,0.0
restaurant,564,2,0,0.0,NULL,0,0.0,0,0.0
restaurant,565,1,0,0.0,NULL,0,0.0,0,0.0
restaurant,566,4,0,0.0,NULL,0,0.0,0,0.0
restaurant,567,3,0,0.0,NULL,0,0.0,0,0.0
restaurant,568,4,1,0.25,1.0,0,0.0,1,0.25
restaurant,569,4,2,0.5,1.0,0,0.0,2,0.5
restaurant,570,4,1,0.25,1.0,0,0.0,1,0.25
restaurant,571,1,1,1.0,0.0,1,1.0,0,0.0
restaurant,572,3,0,0.0,NULL,0,0.0,0,0.0
restaurant,573,1,0,0.0,NULL,0,0.0,0,0.0
restaurant,574,4,0,0.0,NULL,0,0.0,0,0.0
restaurant,575,6,0,0.0,NULL,0,0.0,0,0.0
restaurant,576,3,0,0.0,NULL,0,0.0,0,0.0
restaurant,577,4,1,0.25,0.0,1,0.25,0,0.0
restaurant,578,1,0,0.0,NULL,0,0.0,0,0.0
restaurant,579,4,2,0.5,1.0,0,0.0,2,0.5
restaurant,580,2,0,0.0,NULL,0,0.0,0,0.0
restaurant,581,2,0,0.0,NULL,0,0.0,0,0.0
restaurant,582,2,0,0.0,NULL,0,0.0,0,0.0
restaurant,583,3,0,0.0,NULL,0,0.0,0,0.0
restaurant,584,8,2,0.25,0.5,1,0.125,1,0.125
restaurant,585,1,0,0.0,NULL,0,0.0,0,0.0
restaurant,586,2,0,0.0,NULL,0,0.0,0,0.0
restaurant,587,4,0,0.0,NULL,0,0.0,0,0.0
restaurant,588,2,0,0.0,NULL,0,0.0,0,0.0
restaurant,589,1,1,1.0,0.0,1,1.0,0,0.0
restaurant,590,4,1,0.25,1.0,0,0.0,1,0.25
restaurant,591,3,0,0.0,NULL,0,0.0,0,0.0
restaurant,592,4,1,0.25,0.0,1,0.25,0,0.0
restaurant,593,2,1,0.5,1.0,0,0.0,1,0.5
restaurant,594,3,0,0.0,NULL,0,0.0,0,0.0
restaurant,595,1,1,1.0,1.0,0,0.0,1,1.0
restaurant,596,4,1,0.25,0.0,1,0.25,0,0.0
restaurant,597,3,1,0.333333333333,0.0,1,0.333333333333,0,0.0
restaurant,598,1,0,0.0,NULL,0,0.0,0,0.0
restaurant,599,2,0,0.0,NULL,0,0.0,0,0.0
restaurant,600,1,0,0.0,NULL,0,0.0,0,0.0
restaurant,601,4,0,0.0,NULL,0,0.0,0,0.0
restaurant,602,5,1,0.2,1.0,0,0.0,1,0.2
restaurant,603,2,0,0.0,NULL,0,0.0,0,0.0
restaurant,604,6,1,0.166666666667,0.0,1,0.166666666667,0,0.0
restaurant,605,1,0,0.0,NULL,0,0.0,0,0.0
restaurant,606,5,0,0.0,NULL,0,0.0,0,0.0
restaurant,607,5,0,0.0,NULL,0,0.0,0,0.0
restaurant,608,4,0,0.0,NULL,0,0.0,0,0.0
restaurant,609,3,0,0.0,NULL,0,0.0,0,0.0
restaurant,610,5,0,0.0,NULL,0,0.0,0,0.0
restaurant,611,3,0,0.0,NULL,0,0.0,0,0.0
restaurant,612,2,2,1.0,0.5,1,0.5,1,0.5
restaurant,613,2,0,0.0,NULL,0,0.0,0,0.0
restaurant,614,4,0,0.0,NULL,0,0.0,0,0.0
restaurant,615,4,1,0.25,1.0,0,0.0,1,0.25
restaurant,616,3,1,0.333333333333,0.0,1,0.333333333333,0,0.0
restaurant,617,2,0,0.0,NULL,0,0.0,0,0.0
restaurant,618,1,0,0.0,NULL,0,0.0,0,0.0
restaurant,619,2,0,0.0,NULL,0,0.0,0,0.0
restaurant,620,3,0,0.0,NULL,0,0.0,0,0.0
restaurant,621,3,0,0.0,NULL,0,0.0,0,0.0
restaurant,622,2,0,0.0,NULL,0,0.0,0,0.0
restaurant,623,4,0,0.0,NULL,0,0.0,0,0.0
restaurant,625,1,0,0.0,NULL,0,0.0,0,0.0
restaurant,626,2,1,0.5,1.0,0,0.0,1,0.5
restaurant,627,2,0,0.0,NULL,0,0.0,0,0.0
restaurant,628,3,0,0.0,NULL,0,0.0,0,0.0
restaurant,629,1,0,0.0,NULL,0,0.0,0,0.0
restaurant,630,4,0,0.0,NULL,0,0.0,0,0.0
restaurant,631,1,0,0.0,NULL,0,0.0,0,0.0
restaurant,632,4,1,0.25,0.0,1,0.25,0,0.0
restaurant,633,4,0,0.0,NULL,0,0.0,0,0.0
restaurant,634,3,1,0.333333333333,0.0,1,0.333333333333,0,0.0
restaurant,635,1,0,0.0,NULL,0,0.0,0,0.0
restaurant,636,1,0,0.0,NULL,0,0.0,0,0.0
restaurant,637,1,0,0.0,NULL,0,0.0,0,0.0
restaurant,638,1,0,0.0,NULL,0,0.0,0,0.0
restaurant,639,2,0,0.0,NULL,0,0.0,0,0.0
restaurant,640,3,0,0.0,NULL,0,0.0,0,0.0
restaurant,641,1,0,0.0,NULL,0,0.0,0,0.0
restaurant,642,2,0,0.0,NULL,0,0.0,0,0.0
restaurant,643,4,0,0.0,NULL,0,0.0,0,0.0
restaurant,644,2,0,0.0,NULL,0,0.0,0,0.0
restaurant,645,1,0,0.0,NULL,0,0.0,0,0.0
restaurant,647,2,1,0.5,0.0,1,0.5,0,0.0
restaurant,648,2,0,0.0,NULL,0,0.0,0,0.0
restaurant,649,3,0,0.0,NULL,0,0.0,0,0.0
restaurant,650,3,1,0.333333333333,1.0,0,0.0,1,0.333333333333
restaurant,651,2,2,1.0,0.5,1,0.5,1,0.5
restaurant,652,2,0,0.0,NULL,0,0.0,0,0.0
restaurant,654,2,0,0.0,NULL,0,0.0,0,0.0
restaurant,656,3,1,0.333333333333,0.0,1,0.333333333333,0,0.0
restaurant,657,2,0,0.0,NULL,0,0.0,0,0.0
restaurant,658,2,0,0.0,NULL,0,0.0,0,0.0
restaurant,660,1,0,0.0,NULL,0,0.0,0,0.0
restaurant,661,2,0,0.0,NULL,0,0.0,0,0.0
restaurant,662,3,0,0.0,NULL,0,0.0,0,0.0
restaurant,664,4,2,0.5,0.5,1,0.25,1,0.25
restaurant,665,3,1,0.333333333333,1.0,0,0.0,1,0.333333333333
restaurant,666,1,0,0.0,NULL,0,0.0,0,0.0
restaurant,667,2,0,0.0,NULL,0,0.0,0,0.0
restaurant,669,1,0,0.0,NULL,0,0.0,0,0.0
restaurant,671,5,1,0.2,0.0,1,0.2,0,0.0
restaurant,672,1,0,0.0,NULL,0,0.0,0,0.0
restaurant,673,3,0,0.0,NULL,0,0.0,0,0.0
restaurant,674,1,0,0.0,NULL,0,0.0,0,0.0
restaurant,675,3,0,0.0,NULL,0,0.0,0,0.0
restaurant,676,2,0,0.0,NULL,0,0.0,0,0.0
restaurant,678,2,0,0.0,NULL,0,0.0,0,0.0
restaurant,679,2,1,0.5,0.0,1,0.5,0,0.0
restaurant,680,4,0,0.0,NULL,0,0.0,0,0.0
restaurant,681,1,0,0.0,NULL,0,0.0,0,0.0
restaurant,682,1,0,0.0,NULL,0,0.0,0,0.0
restaurant,683,1,0,0.0,NULL,0,0.0,0,0.0
restaurant,684,1,0,0.0,NULL,0,0.0,0,0.0
restaurant,685,2,0,0.0,NULL,0,0.0,0,0.0
restaurant,686,1,0,0.0,NULL,0,0.0,0,0.0
restaurant,688,2,0,0.0,NULL,0,0.0,0,0.0
restaurant,689,2,1,0.5,0.0,1,0.5,0,0.0
restaurant,690,1,0,0.0,NULL,0,0.0,0,0.0
restaurant,693,1,0,0.0,NULL,0,0.0,0,0.0
restaurant,695,5,0,0.0,NULL,0,0.0,0,0.0
restaurant,696,1,0,0.0,NULL,0,0.0,0,0.0
restaurant,698,1,0,0.0,NULL,0,0.0,0,0.0
restaurant,699,2,0,0.0,NULL,0,0.0,0,0.0
restaurant,700,1,0,0.0,NULL,0,0.0,0,0.0
restaurant,701,1,0,0.0,NULL,0,0.0,0,0.0
restaurant,702,3,0,0.0,NULL,0,0.0,0,0.0
restaurant,703,1,0,0.0,NULL,0,0.0,0,0.0
restaurant,704,3,0,0.0,NULL,0,0.0,0,0.0
restaurant,705,4,1,0.25,0.0,1,0.25,0,0.0
restaurant,706,4,0,0.0,NULL,0,0.0,0,0.0
restaurant,707,2,0,0.0,NULL,0,0.0,0,0.0
restaurant,708,2,0,0.0,NULL,0,0.0,0,0.0
restaurant,709,1,0,0.0,NULL,0,0.0,0,0.0
restaurant,711,2,1,0.5,0.0,1,0.5,0,0.0
restaurant,712,1,1,1.0,0.0,1,1.0,0,0.0
restaurant,713,2,0,0.0,NULL,0,0.0,0,0.0
restaurant,714,4,0,0.0,NULL,0,0.0,0,0.0
restaurant,715,2,0,0.0,NULL,0,0.0,0,0.0
restaurant,716,1,1,1.0,1.0,0,0.0,1,1.0
restaurant,718,2,0,0.0,NULL,0,0.0,0,0.0
restaurant,719,1,0,0.0,NULL,0,0.0,0,0.0
restaurant,720,2,0,0.0,NULL,0,0.0,0,0.0
restaurant,721,1,0,0.0,NULL,0,0.0,0,0.0
restaurant,723,1,0,0.0,NULL,0,0.0,0,0.0
restaurant,725,1,0,0.0,NULL,0,0.0,0,0.0
restaurant,726,1,0,0.0,NULL,0,0.0,0,0.0
restaurant,727,1,0,0.0,NULL,0,0.0,0,0.0
restaurant,728,4,0,0.0,NULL,0,0.0,0,0.0
restaurant,732,1,0,0.0,NULL,0,0.0,0,0.0
restaurant,733,4,1,0.25,0.0,1,0.25,0,0.0
restaurant,736,4,0,0.0,NULL,0,0.0,0,0.0
restaurant,737,1,0,0.0,NULL,0,0.0,0,0.0
restaurant,738,3,0,0.0,NULL,0,0.0,0,0.0
restaurant,741,3,0,0.0,NULL,0,0.0,0,0.0
restaurant,742,1,0,0.0,NULL,0,0.0,0,0.0
restaurant,744,1,1,1.0,0.0,1,1.0,0,0.0
restaurant,746,1,0,0.0,NULL,0,0.0,0,0.0
restaurant,747,1,0,0.0,NULL,0,0.0,0,0.0
restaurant,749,1,0,0.0,NULL,0,0.0,0,0.0
restaurant,750,3,0,0.0,NULL,0,0.0,0,0.0
restaurant,751,1,0,0.0,NULL,0,0.0,0,0.0
restaurant,754,2,0,0.0,NULL,0,0.0,0,0.0
restaurant,755,2,0,0.0,NULL,0,0.0,0,0.0
restaurant,756,1,0,0.0,NULL,0,0.0,0,0.0
restaurant,757,2,0,0.0,NULL,0,0.0,0,0.0
restaurant,759,1,0,0.0,NULL,0,0.0,0,0.0
restaurant,761,2,1,0.5,0.0,1,0.5,0,0.0
restaurant,763,1,0,0.0,NULL,0,0.0,0,0.0
restaurant,765,4,0,0.0,NULL,0,0.0,0,0.0
restaurant,767,1,0,0.0,NULL,0,0.0,0,0.0
restaurant,768,2,1,0.5,1.0,0,0.0,1,0.5
restaurant,769,1,0,0.0,NULL,0,0.0,0,0.0
restaurant,771,4,0,0.0,NULL,0,0.0,0,0.0
restaurant,772,1,0,0.0,NULL,0,0.0,0,0.0
restaurant,774,3,1,0.333333333333,1.0,0,0.0,1,0.333333333333
restaurant,775,2,0,0.0,NULL,0,0.0,0,0.0
restaurant,776,2,0,0.0,NULL,0,0.0,0,0.0
restaurant,777,1,0,0.0,NULL,0,0.0,0,0.0
restaurant,781,2,1,0.5,1.0,0,0.0,1,0.5
restaurant,783,2,1,0.5,1.0,0,0.0,1,0.5
restaurant,784,3,2,0.666666666667,0.5,1,0.333333333333,1,0.333333333333
