bill_installment,user_num,user_loan_num,loan_rate,reloan_rate,num1,p1,num2,p2
0,3393356,110669,0.0326134363739,0.125410006416,96790,0.028523385109,13879,0.00409005126488
1,99922,4220,0.0422329416945,0.170379146919,3501,0.0350373291167,719,0.00719561257781
2,214373,8881,0.0414277917462,0.174304695417,7333,0.034206733124,1548,0.00722105862212
3,178454,8954,0.05017539534,0.153227607773,7582,0.042487139543,1372,0.00768825579701
4,215617,10826,0.0502093990734,0.16275632736,9064,0.0420375016812,1762,0.00817189739214
5,135543,8271,0.0610212257365,0.15947285697,6952,0.0512899965325,1319,0.00973122920402
6,188122,10739,0.0570852957124,0.16947574262,8919,0.0474107228288,1820,0.00967457288355
7,121931,8004,0.0656436837228,0.175912043978,6596,0.0540961691448,1408,0.0115475145779
8,155560,10366,0.0666366675238,0.177792784102,8523,0.0547891488815,1843,0.0118475186423
9,94897,7159,0.0754396872398,0.194021511384,5770,0.0608027651032,1389,0.0146369221366
10,117834,9092,0.0771593937234,0.182798064232,7430,0.0630548059134,1662,0.01410458781
11,77537,6688,0.0862555941035,0.198714114833,5359,0.0691153900718,1329,0.0171402040316
12,123612,10134,0.0819823318124,0.196862048549,8139,0.065843122027,1995,0.0161392097855
13,71854,6504,0.0905168814541,0.200799507995,5198,0.0723411361928,1306,0.0181757452612
14,97514,9059,0.0928994811001,0.21371012253,7123,0.0730459216113,1936,0.0198535594889
15,61606,6044,0.0981073272084,0.22319655857,4695,0.0762101094049,1349,0.0218972178035
16,75713,7552,0.099745090011,0.228813559322,5824,0.0769220609407,1728,0.0228230290703
17,51702,5473,0.105856639975,0.232413667093,4201,0.0812541100925,1272,0.0246025298828
18,64513,6738,0.104444065537,0.226625111309,5211,0.0807744175593,1527,0.0236696479779
19,46427,5131,0.110517586749,0.23952445917,3902,0.0840459215543,1229,0.0264716651948
20,59680,6571,0.110103887399,0.229493227819,5063,0.0848357908847,1508,0.0252680965147
21,44054,5150,0.116901983929,0.246213592233,3882,0.0881191265265,1268,0.0287828574023
22,48768,5790,0.118725393701,0.240587219344,4397,0.0901615813648,1393,0.028563812336
23,37729,4674,0.123883484853,0.257167308515,3472,0.0920247024835,1202,0.031858782369
24,52076,6008,0.115369844074,0.248668442077,4514,0.0866810046855,1494,0.0286888393886
25,35362,4462,0.126180645891,0.26759300762,3268,0.0924155873537,1194,0.0337650585374
26,40556,5148,0.126935595226,0.25641025641,3828,0.0943880067068,1320,0.0325475885196
27,32668,4242,0.129851842782,0.270862800566,3093,0.0946798089874,1149,0.0351720337945
28,40896,5106,0.124853286385,0.267332549941,3741,0.0914759389671,1365,0.0333773474178
29,29567,4154,0.140494470186,0.276841598459,3004,0.101599756485,1150,0.0388947137011
30,35635,4789,0.134390346569,0.282104823554,3438,0.0964781815631,1351,0.0379121650063
31,27412,3897,0.14216401576,0.269951244547,2845,0.103786662775,1052,0.0383773529841
32,32140,4489,0.139670192906,0.284695923368,3211,0.0999066583696,1278,0.0397635345364
33,25680,3720,0.144859813084,0.300806451613,2601,0.101285046729,1119,0.0435747663551
34,28084,4132,0.147130038456,0.309051306873,2855,0.101659307791,1277,0.0454707306651
35,23783,3618,0.152125467771,0.296296296296,2546,0.107051255098,1072,0.0450742126729
36,28442,4051,0.142430208846,0.289558133794,2878,0.101188383377,1173,0.0412418254694
37,21859,3370,0.154169907132,0.315727002967,2306,0.105494304406,1064,0.0486756027266
38,24390,3803,0.155924559246,0.310281356824,2623,0.107544075441,1180,0.0483804838048
39,20731,3398,0.163909121605,0.313419658623,2333,0.112536780667,1065,0.0513723409387
40,24131,3764,0.155981931955,0.305526036132,2614,0.108325390576,1150,0.0476565413783
41,19349,3262,0.168587523903,0.316676885346,2229,0.115199751925,1033,0.0533877719779
42,22917,3640,0.158834053323,0.319230769231,2478,0.108129336301,1162,0.0507047170223
43,18196,3080,0.169267970983,0.323701298701,2083,0.114475708947,997,0.0547922620356
44,20597,3448,0.167403019857,0.311774941995,2373,0.115210953051,1075,0.0521920668058
45,17773,2968,0.166994879874,0.32884097035,1992,0.112080121533,976,0.0549147583413
46,18490,3162,0.171011357491,0.325110689437,2134,0.115413737155,1028,0.0555976203353
47,15900,2740,0.172327044025,0.342335766423,1802,0.113333333333,938,0.0589937106918
48,18677,3245,0.173743106495,0.326040061633,2187,0.117095893345,1058,0.0566472131499
49,15302,2719,0.177689190955,0.331739610151,1817,0.11874264802,902,0.0589465429356
50,16609,3036,0.182792461918,0.341238471673,2000,0.12041664158,1036,0.0623758203384
51,14464,2550,0.176299778761,0.352156862745,1652,0.11421460177,898,0.0620851769912
52,16062,2871,0.178744863653,0.33402995472,1912,0.119038724941,959,0.0597061387125
53,13509,2577,0.190761714413,0.356616220411,1658,0.12273299282,919,0.068028721593
54,14994,2738,0.182606375884,0.334915997078,1821,0.121448579432,917,0.0611577964519
55,12880,2464,0.191304347826,0.346996753247,1609,0.124922360248,855,0.0663819875776
56,14853,2798,0.188379451963,0.33166547534,1870,0.125900491483,928,0.0624789604794
57,12345,2355,0.190765492102,0.355414012739,1518,0.122964763062,837,0.0678007290401
58,13401,2558,0.190881277517,0.357701329163,1643,0.122602790837,915,0.0682784866801
59,11777,2305,0.195720472107,0.345336225597,1509,0.128131102997,796,0.0675893691093
60,13326,2503,0.187828305568,0.352377147423,1621,0.121641903047,882,0.0661864025214
61,11174,2230,0.199570431359,0.355156950673,1438,0.128691605513,792,0.0708788258457
62,11980,2523,0.210601001669,0.365041617122,1602,0.133722871452,921,0.076878130217
63,10749,2147,0.199739510652,0.37866790871,1334,0.124104567867,813,0.0756349427854
64,11882,2425,0.204090220502,0.367422680412,1534,0.129102844639,891,0.0749873758626
65,10342,2217,0.214368594082,0.392422192152,1347,0.130245600464,870,0.0841229936183
66,10855,2169,0.199815753109,0.357768556939,1393,0.128327959466,776,0.0714877936435
67,9910,2059,0.207769929364,0.366197183099,1305,0.131685166498,754,0.0760847628658
68,10469,2071,0.197822141561,0.346692419121,1353,0.129238704747,718,0.0685834368134
69,9471,2028,0.214127336079,0.378205128205,1261,0.133143279485,767,0.0809840565938
70,10243,2209,0.215659474763,0.377546401086,1375,0.134238016206,834,0.0814214585571
71,8910,1958,0.21975308642,0.384065372829,1206,0.135353535354,752,0.0843995510662
72,9994,2125,0.212627576546,0.380705882353,1316,0.131679007404,809,0.0809485691415
73,8508,1883,0.221321109544,0.390334572491,1148,0.134931828867,735,0.086389280677
74,8992,2040,0.226868327402,0.390196078431,1244,0.13834519573,796,0.0885231316726
75,8151,1854,0.227456753773,0.398058252427,1116,0.136915715863,738,0.0905410379095
76,8859,1979,0.223388644317,0.393127842345,1201,0.135568348572,778,0.0878202957444
77,7881,1739,0.220657276995,0.406555491662,1032,0.130947849258,707,0.0897094277376
78,8523,1932,0.226680746216,0.406832298137,1146,0.13445969729,786,0.0922210489264
79,7430,1736,0.233647375505,0.420506912442,1006,0.135397039031,730,0.0982503364738
80,8126,1832,0.225449175486,0.389192139738,1119,0.137706128476,713,0.0877430470096
81,7315,1718,0.234859876965,0.403376018626,1025,0.14012303486,693,0.0947368421053
82,7583,1769,0.23328497956,0.421707179197,1023,0.13490702888,746,0.0983779506792
83,6949,1671,0.240466254137,0.414123279473,979,0.140883580371,692,0.099582673766
84,7586,1754,0.231215396784,0.42189281642,1014,0.133667281835,740,0.0975481149486
85,6653,1544,0.232075755298,0.415155440415,903,0.135728242898,641,0.0963475124004
86,7106,1671,0.2351533915,0.3907839617,1018,0.143259217563,653,0.0918941739375
87,6277,1516,0.24151664808,0.421503957784,877,0.139716425044,639,0.101800223036
88,6736,1555,0.230849168646,0.406430868167,923,0.137024940618,632,0.0938242280285
89,6178,1530,0.247652962124,0.417647058824,891,0.144221430884,639,0.10343153124
90,6737,1623,0.240908416209,0.402957486137,969,0.143832566424,654,0.0970758497848
91,5991,1435,0.2395259556,0.432055749129,815,0.136037389417,620,0.103488566183
92,6387,1517,0.237513699703,0.423862887278,874,0.136840457179,643,0.100673242524
93,5766,1518,0.263267429761,0.418972332016,882,0.15296566077,636,0.110301768991
94,6011,1485,0.247047080353,0.439057239057,833,0.138579271336,652,0.108467809017
95,5526,1448,0.262034020992,0.439226519337,812,0.146941730004,636,0.115092290988
96,6039,1491,0.246895181321,0.415828303152,871,0.144229177016,620,0.102666004305
97,5346,1360,0.254395809951,0.442647058824,758,0.141788252899,602,0.112607557052
98,5649,1453,0.257213666136,0.415691672402,849,0.150292087095,604,0.106921579041
99,5187,1339,0.258145363409,0.4428678118,746,0.14382109119,593,0.114324272219
100,5468,1394,0.254937820044,0.444045911047,775,0.141733723482,619,0.113204096562
101,4940,1300,0.263157894737,0.443846153846,723,0.146356275304,577,0.116801619433
102,5353,1400,0.261535587521,0.434285714286,792,0.147954418083,608,0.113581169438
103,4955,1282,0.258728557013,0.45631825273,697,0.140665993946,585,0.118062563068
104,5217,1367,0.262027985432,0.425749817118,785,0.150469618555,582,0.111558366878
105,4763,1270,0.266638673105,0.440157480315,711,0.149275666597,559,0.117363006509
106,4922,1285,0.261072734661,0.452140077821,704,0.143031288094,581,0.118041446566
107,4410,1186,0.268934240363,0.464586846543,635,0.143990929705,551,0.124943310658
108,4846,1238,0.255468427569,0.442649434572,690,0.142385472555,548,0.113082955014
109,4472,1212,0.271019677996,0.436468646865,683,0.152728085868,529,0.118291592129
110,4626,1252,0.270644185041,0.44089456869,700,0.151318633809,552,0.119325551232
111,4219,1172,0.277790945722,0.46843003413,623,0.147665323536,549,0.130125622185
112,4531,1165,0.257117634076,0.445493562232,646,0.142573383359,519,0.114544250717
113,4093,1122,0.274126557537,0.467023172906,598,0.146103102859,524,0.128023454679
114,4330,1197,0.276443418014,0.462823725982,643,0.148498845266,554,0.127944572748
115,3960,1036,0.261616161616,0.466216216216,553,0.139646464646,483,0.12196969697
116,4059,1129,0.278147326928,0.479185119575,588,0.144863266814,541,0.133284060113
117,3818,1122,0.293871136721,0.459001782531,607,0.158983761131,515,0.134887375589
118,4038,1125,0.278603268945,0.458666666667,609,0.150817236256,516,0.127786032689
119,3729,1078,0.289085545723,0.468460111317,573,0.153660498793,505,0.135425046929
120,3968,1093,0.275453629032,0.488563586459,559,0.140877016129,534,0.134576612903
121,3658,1078,0.294696555495,0.470315398887,571,0.156096227447,507,0.138600328048
122,3738,1130,0.302300695559,0.469911504425,599,0.16024612092,531,0.142054574639
123,3477,1028,0.295657175726,0.477626459144,537,0.154443485764,491,0.141213689963
124,3562,1039,0.291690061763,0.449470644851,572,0.160583941606,467,0.131106120157
125,3331,977,0.29330531372,0.474923234391,513,0.154007805464,464,0.139297508256
126,3568,1046,0.293161434978,0.483747609943,540,0.15134529148,506,0.141816143498
127,3255,953,0.292780337942,0.464847848898,510,0.15668202765,443,0.136098310292
128,3497,1051,0.300543322848,0.46146527117,566,0.161853016872,485,0.138690305977
129,3259,985,0.302239950905,0.460913705584,531,0.162933415158,454,0.139306535747
130,3365,998,0.296582466568,0.437875751503,561,0.166716196137,437,0.129866270431
131,3042,930,0.305719921105,0.452688172043,509,0.167324128863,421,0.138395792242
132,3236,940,0.290482076638,0.46170212766,506,0.156365883807,434,0.134116192831
133,3050,929,0.304590163934,0.503767491927,461,0.151147540984,468,0.153442622951
134,3146,953,0.302924348379,0.494228751312,482,0.153210425938,471,0.149713922441
135,2943,890,0.302412504247,0.473033707865,469,0.159361196058,421,0.143051308189
136,3051,873,0.286135693215,0.521191294387,418,0.137004260898,455,0.149131432317
137,2819,891,0.316069528201,0.476992143659,466,0.165306846399,425,0.150762681802
138,3065,925,0.301794453507,0.482162162162,479,0.156280587276,446,0.145513866232
139,2796,853,0.305078683834,0.506447831184,421,0.150572246066,432,0.154506437768
140,2966,928,0.312879298719,0.48275862069,480,0.161834120027,448,0.151045178692
141,2780,883,0.317625899281,0.505096262741,437,0.157194244604,446,0.160431654676
142,2832,891,0.314618644068,0.516273849607,431,0.152189265537,460,0.162429378531
143,2637,825,0.312855517634,0.499393939394,413,0.156617368221,412,0.156238149412
144,2770,864,0.311913357401,0.49537037037,436,0.157400722022,428,0.154512635379
145,2618,832,0.317799847212,0.510817307692,407,0.155462184874,425,0.162337662338
146,2655,835,0.31450094162,0.51377245509,406,0.152919020716,429,0.161581920904
147,2545,832,0.326915520629,0.508413461538,409,0.160707269155,423,0.166208251473
148,2644,828,0.313161875946,0.495169082126,418,0.158093797277,410,0.155068078669
149,2475,817,0.330101010101,0.494492044064,413,0.166868686869,404,0.163232323232
150,2582,817,0.316421378776,0.505507955936,404,0.156467854376,413,0.1599535244
151,2449,811,0.331155573704,0.494451294698,410,0.167415271539,401,0.163740302164
152,2494,811,0.325180433039,0.525277435265,385,0.154370489174,426,0.170809943865
153,2363,754,0.319085907744,0.501326259947,376,0.159119763013,378,0.159966144731
154,2374,762,0.32097725358,0.515748031496,369,0.155433866891,393,0.165543386689
155,2203,766,0.347707671357,0.513054830287,373,0.169314571039,393,0.178393100318
156,2339,764,0.326635314237,0.514397905759,371,0.158614792646,393,0.16802052159
157,2197,694,0.315885298134,0.520172910663,333,0.151570323168,361,0.164314974966
158,2244,742,0.330659536542,0.493261455526,376,0.167557932264,366,0.163101604278
159,2122,698,0.328934967012,0.514326647564,339,0.159754948162,359,0.16918001885
160,2184,718,0.328754578755,0.519498607242,345,0.157967032967,373,0.170787545788
161,2099,701,0.333968556455,0.513552068474,341,0.162458313483,360,0.171510242973
162,2070,667,0.322222222222,0.487256371814,342,0.165217391304,325,0.157004830918
163,2035,682,0.335135135135,0.539589442815,314,0.1542997543,368,0.180835380835
164,2106,687,0.326210826211,0.540029112082,316,0.150047483381,371,0.17616334283
165,2017,643,0.318790282598,0.56298600311,281,0.139315815568,362,0.17947446703
166,2047,689,0.3365901319,0.481857764877,357,0.174401563263,332,0.162188568637
167,1907,625,0.327739905611,0.5296,294,0.154168851599,331,0.173571054012
168,2057,682,0.331550802139,0.505865102639,337,0.163830821585,345,0.167719980554
169,1818,608,0.334433443344,0.516447368421,294,0.161716171617,314,0.172717271727
170,1904,644,0.338235294118,0.534161490683,300,0.15756302521,344,0.180672268908
171,1828,592,0.323851203501,0.525337837838,281,0.153719912473,311,0.170131291028
172,1933,670,0.346611484739,0.528358208955,316,0.163476461459,354,0.18313502328
173,1746,578,0.331042382589,0.531141868512,271,0.155211912944,307,0.175830469645
174,1829,623,0.340623291416,0.495987158909,314,0.171678512849,309,0.168944778568
175,1857,646,0.347872913301,0.53560371517,300,0.16155088853,346,0.186322024771
176,1866,632,0.338692390139,0.526898734177,299,0.160235798499,333,0.17845659164
177,1710,608,0.355555555556,0.521381578947,291,0.170175438596,317,0.185380116959
178,1743,598,0.343086632243,0.484949832776,308,0.176706827309,290,0.166379804934
179,1718,570,0.331781140861,0.536842105263,264,0.153667054715,306,0.178114086147
180,1730,589,0.340462427746,0.563667232598,257,0.148554913295,332,0.191907514451
181,1600,578,0.36125,0.539792387543,266,0.16625,312,0.195
182,1724,602,0.349187935035,0.536544850498,279,0.161832946636,323,0.187354988399
183,1565,567,0.362300319489,0.560846560847,249,0.15910543131,318,0.203194888179
184,1676,580,0.346062052506,0.529310344828,273,0.162887828162,307,0.183174224344
185,1527,562,0.368041912246,0.508896797153,276,0.180746561886,286,0.18729535036
186,1646,588,0.357229647631,0.530612244898,276,0.167679222357,312,0.189550425273
187,1504,499,0.331781914894,0.541082164329,229,0.152260638298,270,0.179521276596
188,1574,564,0.3583227446,0.505319148936,279,0.177255400254,285,0.181067344346
189,1461,535,0.366187542779,0.500934579439,267,0.182751540041,268,0.183436002738
190,1511,549,0.363335539378,0.520947176685,263,0.17405691595,286,0.189278623428
191,1448,516,0.35635359116,0.529069767442,243,0.167817679558,273,0.188535911602
192,1492,520,0.348525469169,0.544230769231,237,0.158847184987,283,0.189678284182
193,1402,542,0.386590584879,0.516605166052,262,0.186875891583,280,0.199714693295
194,1507,548,0.363636363636,0.554744525547,244,0.161911081619,304,0.201725282017
195,1409,513,0.364088005678,0.569200779727,221,0.156848828957,292,0.207239176721
196,1427,498,0.34898388227,0.548192771084,225,0.157673440785,273,0.191310441486
197,1361,499,0.366642174871,0.527054108216,236,0.17340191036,263,0.193240264511
198,1419,471,0.331923890063,0.594479830149,191,0.134601832276,280,0.197322057787
199,1426,547,0.383590462833,0.555758683729,243,0.170406732118,304,0.213183730715
200,1395,488,0.34982078853,0.536885245902,226,0.162007168459,262,0.187813620072
201,1268,465,0.366719242902,0.518279569892,224,0.17665615142,241,0.190063091483
202,1371,511,0.372720641867,0.526418786693,242,0.1765134938,269,0.196207148067
203,1257,455,0.361972951472,0.584615384615,189,0.150357995227,266,0.211614956245
204,1385,517,0.373285198556,0.522243713733,247,0.178339350181,270,0.194945848375
205,1216,459,0.377467105263,0.579520697168,193,0.158717105263,266,0.21875
206,1252,479,0.382587859425,0.559498956159,211,0.168530351438,268,0.214057507987
207,1239,463,0.373688458434,0.539956803456,213,0.17191283293,250,0.201775625504
208,1239,429,0.346246973366,0.538461538462,198,0.1598062954,231,0.186440677966
209,1180,464,0.393220338983,0.573275862069,198,0.167796610169,266,0.225423728814
210,1189,448,0.376787216148,0.546875,203,0.170731707317,245,0.206055508831
211,1144,438,0.382867132867,0.545662100457,199,0.173951048951,239,0.208916083916
212,1187,456,0.384161752317,0.546052631579,207,0.174389216512,249,0.209772535805
213,1133,394,0.347749338041,0.568527918782,170,0.150044130627,224,0.197705207414
214,1125,429,0.381333333333,0.536130536131,199,0.176888888889,230,0.204444444444
215,1066,411,0.385553470919,0.574209245742,175,0.164165103189,236,0.22138836773
216,1171,423,0.36122971819,0.557919621749,187,0.159692570453,236,0.201537147737
217,1070,439,0.410280373832,0.571753986333,188,0.175700934579,251,0.234579439252
218,1137,393,0.345646437995,0.582697201018,164,0.144239226033,229,0.201407211961
219,1016,386,0.379921259843,0.575129533679,164,0.161417322835,222,0.218503937008
220,1121,412,0.367528991971,0.541262135922,189,0.168599464764,223,0.198929527208
221,1086,409,0.376611418048,0.557457212714,181,0.166666666667,228,0.209944751381
222,1136,445,0.391725352113,0.54606741573,202,0.177816901408,243,0.213908450704
223,1047,384,0.36676217765,0.5625,168,0.160458452722,216,0.206303724928
224,1012,373,0.368577075099,0.560321715818,164,0.162055335968,209,0.20652173913
225,1033,387,0.374636979671,0.576227390181,164,0.15876089061,223,0.215876089061
226,1035,425,0.410628019324,0.592941176471,173,0.167149758454,252,0.24347826087
227,999,385,0.385385385385,0.548051948052,174,0.174174174174,211,0.211211211211
228,1011,397,0.392680514342,0.531486146096,186,0.183976261128,211,0.208704253215
229,987,385,0.390070921986,0.618181818182,147,0.148936170213,238,0.241134751773
230,1041,380,0.365033621518,0.615789473684,146,0.140249759846,234,0.224783861671
231,928,389,0.419181034483,0.596401028278,157,0.169181034483,232,0.25
232,1018,391,0.384086444008,0.539641943734,180,0.176817288802,211,0.207269155206
233,926,344,0.371490280778,0.563953488372,150,0.161987041037,194,0.209503239741
234,958,369,0.385177453027,0.525745257453,175,0.18267223382,194,0.202505219207
235,940,364,0.387234042553,0.552197802198,163,0.173404255319,201,0.213829787234
236,929,361,0.388589881593,0.554016620499,161,0.173304628633,200,0.21528525296
237,899,330,0.367074527253,0.578787878788,139,0.154616240267,191,0.212458286986
238,909,365,0.401540154015,0.58904109589,150,0.16501650165,215,0.236523652365
239,874,342,0.391304347826,0.535087719298,159,0.181922196796,183,0.20938215103
240,896,365,0.407366071429,0.550684931507,164,0.183035714286,201,0.224330357143
241,853,328,0.384525205158,0.557926829268,145,0.169988276671,183,0.214536928488
242,905,385,0.425414364641,0.592207792208,157,0.173480662983,228,0.251933701657
243,855,343,0.401169590643,0.606413994169,135,0.157894736842,208,0.243274853801
244,844,326,0.386255924171,0.638036809816,118,0.13981042654,208,0.24644549763
245,812,325,0.400246305419,0.572307692308,139,0.17118226601,186,0.229064039409
246,900,353,0.392222222222,0.563739376771,154,0.171111111111,199,0.221111111111
247,817,331,0.405140758874,0.589123867069,136,0.166462668299,195,0.238678090575
248,795,316,0.39748427673,0.582278481013,132,0.166037735849,184,0.231446540881
249,781,307,0.393085787452,0.583061889251,128,0.163892445583,179,0.229193341869
250,871,373,0.428243398393,0.584450402145,155,0.177956371986,218,0.250287026406
251,734,291,0.396457765668,0.59793814433,117,0.159400544959,174,0.237057220708
252,836,329,0.393540669856,0.589665653495,135,0.161483253589,194,0.232057416268
253,761,296,0.388961892247,0.611486486486,115,0.15111695138,181,0.237844940867
254,794,323,0.406801007557,0.625386996904,121,0.152392947103,202,0.254408060453
255,766,298,0.389033942559,0.61744966443,114,0.148825065274,184,0.240208877285
256,812,319,0.392857142857,0.58934169279,131,0.161330049261,188,0.231527093596
257,757,311,0.410832232497,0.581993569132,130,0.171730515192,181,0.239101717305
258,750,317,0.422666666667,0.577287066246,134,0.178666666667,183,0.244
259,759,309,0.407114624506,0.611650485437,120,0.158102766798,189,0.249011857708
260,787,339,0.430749682338,0.6401179941,122,0.15501905972,217,0.275730622618
261,768,326,0.424479166667,0.592024539877,133,0.173177083333,193,0.251302083333
262,759,328,0.432147562582,0.594512195122,133,0.175230566535,195,0.256916996047
263,718,287,0.399721448468,0.564459930314,125,0.174094707521,162,0.225626740947
264,722,281,0.3891966759,0.580071174377,118,0.163434903047,163,0.225761772853
265,734,299,0.407356948229,0.665551839465,100,0.136239782016,199,0.271117166213
266,730,301,0.412328767123,0.634551495017,110,0.150684931507,191,0.261643835616
267,669,276,0.412556053812,0.630434782609,102,0.152466367713,174,0.260089686099
268,721,304,0.421636615811,0.611842105263,118,0.163661581137,186,0.257975034674
269,694,315,0.453890489914,0.603174603175,125,0.180115273775,190,0.273775216138
270,739,311,0.420838971583,0.569131832797,134,0.181326116373,177,0.23951285521
271,730,302,0.413698630137,0.572847682119,129,0.176712328767,173,0.23698630137
272,698,303,0.434097421203,0.633663366337,111,0.159025787966,192,0.275071633238
273,663,266,0.401206636501,0.612781954887,103,0.155354449472,163,0.245852187029
274,689,296,0.429608127721,0.574324324324,126,0.182873730044,170,0.246734397678
275,658,283,0.43009118541,0.604240282686,112,0.170212765957,171,0.259878419453
276,628,260,0.414012738854,0.584615384615,108,0.171974522293,152,0.242038216561
277,606,234,0.386138613861,0.564102564103,102,0.168316831683,132,0.217821782178
278,666,298,0.447447447447,0.58389261745,124,0.186186186186,174,0.261261261261
279,570,248,0.435087719298,0.616935483871,95,0.166666666667,153,0.268421052632
280,588,255,0.433673469388,0.592156862745,104,0.176870748299,151,0.256802721088
281,613,258,0.42088091354,0.631782945736,95,0.154975530179,163,0.265905383361
282,614,254,0.413680781759,0.602362204724,101,0.164495114007,153,0.249185667752
283,613,246,0.401305057096,0.626016260163,92,0.150081566069,154,0.251223491028
284,598,264,0.441471571906,0.617424242424,101,0.16889632107,163,0.272575250836
285,588,234,0.397959183673,0.65811965812,80,0.136054421769,154,0.261904761905
286,587,249,0.424190800681,0.562248995984,109,0.185689948893,140,0.238500851789
287,560,248,0.442857142857,0.568548387097,107,0.191071428571,141,0.251785714286
288,643,270,0.419906687403,0.577777777778,114,0.177293934681,156,0.242612752722
289,551,240,0.43557168784,0.5625,105,0.19056261343,135,0.24500907441
290,578,244,0.42214532872,0.594262295082,99,0.171280276817,145,0.250865051903
291,539,234,0.43413729128,0.57264957265,100,0.185528756957,134,0.248608534323
292,547,238,0.435100548446,0.596638655462,96,0.17550274223,142,0.259597806216
293,555,237,0.427027027027,0.62447257384,89,0.16036036036,148,0.266666666667
294,557,223,0.400359066427,0.614349775785,86,0.154398563734,137,0.245960502693
295,578,245,0.423875432526,0.612244897959,95,0.164359861592,150,0.259515570934
296,578,252,0.43598615917,0.59126984127,103,0.178200692042,149,0.257785467128
297,548,220,0.401459854015,0.590909090909,90,0.164233576642,130,0.237226277372
298,553,234,0.423146473779,0.615384615385,90,0.162748643761,144,0.260397830018
299,486,218,0.448559670782,0.600917431193,87,0.179012345679,131,0.269547325103
300,537,244,0.454376163873,0.561475409836,107,0.199255121043,137,0.255121042831
301,515,222,0.431067961165,0.630630630631,82,0.159223300971,140,0.271844660194
302,531,221,0.416195856874,0.669683257919,73,0.13747645951,148,0.278719397363
303,513,223,0.43469785575,0.605381165919,88,0.171539961014,135,0.263157894737
304,486,201,0.413580246914,0.542288557214,92,0.189300411523,109,0.224279835391
305,517,202,0.390715667311,0.564356435644,88,0.170212765957,114,0.220502901354
306,520,232,0.446153846154,0.594827586207,94,0.180769230769,138,0.265384615385
307,514,241,0.468871595331,0.609958506224,94,0.182879377432,147,0.285992217899
308,476,209,0.439075630252,0.645933014354,74,0.155462184874,135,0.283613445378
309,478,222,0.464435146444,0.599099099099,89,0.186192468619,133,0.278242677824
310,474,208,0.438818565401,0.625,78,0.164556962025,130,0.274261603376
311,462,193,0.417748917749,0.689119170984,60,0.12987012987,133,0.287878787879
312,422,176,0.417061611374,0.619318181818,67,0.158767772512,109,0.258293838863
313,468,187,0.399572649573,0.663101604278,63,0.134615384615,124,0.264957264957
314,484,201,0.415289256198,0.616915422886,77,0.159090909091,124,0.256198347107
315,457,203,0.44420131291,0.581280788177,85,0.185995623632,118,0.258205689278
316,476,221,0.464285714286,0.656108597285,76,0.159663865546,145,0.304621848739
317,460,226,0.491304347826,0.632743362832,83,0.180434782609,143,0.310869565217
318,425,191,0.449411764706,0.61780104712,73,0.171764705882,118,0.277647058824
319,452,193,0.426991150442,0.554404145078,86,0.190265486726,107,0.236725663717
320,495,246,0.49696969697,0.581300813008,103,0.208080808081,143,0.288888888889
321,469,212,0.452025586354,0.594339622642,86,0.183368869936,126,0.268656716418
322,450,193,0.428888888889,0.59067357513,79,0.175555555556,114,0.253333333333
323,420,198,0.471428571429,0.606060606061,78,0.185714285714,120,0.285714285714
324,444,192,0.432432432432,0.59375,78,0.175675675676,114,0.256756756757
325,428,198,0.46261682243,0.606060606061,78,0.182242990654,120,0.280373831776
326,442,202,0.457013574661,0.633663366337,74,0.16742081448,128,0.289592760181
327,419,183,0.436754176611,0.677595628415,59,0.140811455847,124,0.295942720764
328,414,180,0.434782608696,0.622222222222,68,0.164251207729,112,0.270531400966
329,386,176,0.455958549223,0.596590909091,71,0.183937823834,105,0.272020725389
330,425,183,0.430588235294,0.606557377049,72,0.169411764706,111,0.261176470588
331,439,192,0.437357630979,0.723958333333,53,0.120728929385,139,0.316628701595
332,391,165,0.42199488491,0.648484848485,58,0.148337595908,107,0.273657289003
333,368,165,0.448369565217,0.624242424242,62,0.16847826087,103,0.279891304348
334,390,185,0.474358974359,0.664864864865,62,0.158974358974,123,0.315384615385
335,387,176,0.454780361757,0.613636363636,68,0.175710594315,108,0.279069767442
336,408,183,0.448529411765,0.612021857923,71,0.174019607843,112,0.274509803922
337,385,188,0.488311688312,0.63829787234,68,0.176623376623,120,0.311688311688
338,367,168,0.457765667575,0.619047619048,64,0.174386920981,104,0.283378746594
339,362,164,0.453038674033,0.640243902439,59,0.162983425414,105,0.290055248619
340,402,198,0.492537313433,0.530303030303,93,0.231343283582,105,0.261194029851
341,360,162,0.45,0.66049382716,55,0.152777777778,107,0.297222222222
342,373,163,0.436997319035,0.650306748466,57,0.152815013405,106,0.28418230563
343,367,147,0.400544959128,0.591836734694,60,0.16348773842,87,0.237057220708
344,363,154,0.424242424242,0.558441558442,68,0.187327823691,86,0.236914600551
345,344,155,0.450581395349,0.638709677419,56,0.162790697674,99,0.287790697674
346,391,163,0.416879795396,0.638036809816,59,0.150895140665,104,0.265984654731
347,339,149,0.439528023599,0.637583892617,54,0.159292035398,95,0.280235988201
348,352,158,0.448863636364,0.670886075949,52,0.147727272727,106,0.301136363636
349,320,142,0.44375,0.633802816901,52,0.1625,90,0.28125
350,355,159,0.447887323944,0.622641509434,60,0.169014084507,99,0.278873239437
351,348,167,0.479885057471,0.664670658683,56,0.16091954023,111,0.318965517241
352,333,157,0.471471471471,0.662420382166,53,0.159159159159,104,0.312312312312
353,329,141,0.428571428571,0.539007092199,65,0.197568389058,76,0.231003039514
354,355,158,0.445070422535,0.639240506329,57,0.160563380282,101,0.284507042254
355,321,143,0.445482866044,0.629370629371,53,0.165109034268,90,0.280373831776
356,351,175,0.498575498575,0.617142857143,67,0.190883190883,108,0.307692307692
357,321,135,0.420560747664,0.592592592593,55,0.171339563863,80,0.249221183801
358,351,173,0.492877492877,0.595375722543,70,0.19943019943,103,0.293447293447
359,317,166,0.523659305994,0.60843373494,65,0.205047318612,101,0.318611987382
360,313,163,0.520766773163,0.705521472393,48,0.153354632588,115,0.367412140575
361,351,154,0.438746438746,0.642857142857,55,0.156695156695,99,0.282051282051
362,326,144,0.441717791411,0.611111111111,56,0.171779141104,88,0.269938650307
363,325,152,0.467692307692,0.611842105263,59,0.181538461538,93,0.286153846154
364,302,140,0.46357615894,0.621428571429,53,0.175496688742,87,0.288079470199
365,296,136,0.459459459459,0.632352941176,50,0.168918918919,86,0.290540540541
366,352,184,0.522727272727,0.614130434783,71,0.201704545455,113,0.321022727273
367,282,142,0.503546099291,0.619718309859,54,0.191489361702,88,0.312056737589
368,311,145,0.466237942122,0.565517241379,63,0.202572347267,82,0.263665594855
369,300,148,0.493333333333,0.695945945946,45,0.15,103,0.343333333333
370,277,109,0.393501805054,0.706422018349,32,0.115523465704,77,0.27797833935
371,282,136,0.482269503546,0.683823529412,43,0.152482269504,93,0.329787234043
372,286,117,0.409090909091,0.683760683761,37,0.129370629371,80,0.27972027972
373,305,143,0.468852459016,0.643356643357,51,0.167213114754,92,0.301639344262
374,283,130,0.459363957597,0.638461538462,47,0.166077738516,83,0.293286219081
375,263,129,0.490494296578,0.635658914729,47,0.178707224335,82,0.311787072243
376,298,136,0.456375838926,0.544117647059,62,0.208053691275,74,0.248322147651
377,285,137,0.480701754386,0.678832116788,44,0.154385964912,93,0.326315789474
378,284,125,0.44014084507,0.56,55,0.193661971831,70,0.246478873239
379,276,131,0.474637681159,0.564885496183,57,0.20652173913,74,0.268115942029
380,299,150,0.501672240803,0.6,60,0.200668896321,90,0.301003344482
381,289,135,0.467128027682,0.718518518519,38,0.131487889273,97,0.335640138408
382,279,128,0.458781362007,0.71875,36,0.129032258065,92,0.329749103943
383,267,124,0.464419475655,0.661290322581,42,0.157303370787,82,0.307116104869
384,287,134,0.466898954704,0.589552238806,55,0.191637630662,79,0.275261324042
385,264,142,0.537878787879,0.640845070423,51,0.193181818182,91,0.344696969697
386,290,138,0.475862068966,0.659420289855,47,0.162068965517,91,0.313793103448
387,256,112,0.4375,0.580357142857,47,0.18359375,65,0.25390625
388,262,109,0.416030534351,0.660550458716,37,0.141221374046,72,0.274809160305
389,286,134,0.468531468531,0.694029850746,41,0.143356643357,93,0.325174825175
390,279,129,0.462365591398,0.666666666667,43,0.154121863799,86,0.308243727599
391,249,104,0.417670682731,0.596153846154,42,0.168674698795,62,0.248995983936
392,266,123,0.462406015038,0.650406504065,43,0.161654135338,80,0.300751879699
393,256,110,0.4296875,0.654545454545,38,0.1484375,72,0.28125
394,262,113,0.431297709924,0.672566371681,37,0.141221374046,76,0.290076335878
395,264,126,0.477272727273,0.611111111111,49,0.185606060606,77,0.291666666667
396,257,112,0.43579766537,0.732142857143,30,0.11673151751,82,0.31906614786
397,266,137,0.515037593985,0.649635036496,48,0.18045112782,89,0.334586466165
398,246,128,0.520325203252,0.65625,44,0.178861788618,84,0.341463414634
399,264,121,0.458333333333,0.636363636364,44,0.166666666667,77,0.291666666667
400,245,109,0.444897959184,0.587155963303,45,0.183673469388,64,0.261224489796
401,252,123,0.488095238095,0.674796747967,40,0.15873015873,83,0.329365079365
402,258,136,0.527131782946,0.669117647059,45,0.174418604651,91,0.352713178295
403,235,109,0.463829787234,0.596330275229,44,0.187234042553,65,0.276595744681
404,236,101,0.427966101695,0.584158415842,42,0.177966101695,59,0.25
405,243,115,0.473251028807,0.608695652174,45,0.185185185185,70,0.288065843621
406,238,107,0.449579831933,0.654205607477,37,0.155462184874,70,0.294117647059
407,208,99,0.475961538462,0.686868686869,31,0.149038461538,68,0.326923076923
408,230,113,0.491304347826,0.646017699115,40,0.173913043478,73,0.317391304348
409,232,114,0.491379310345,0.605263157895,45,0.193965517241,69,0.297413793103
410,233,113,0.484978540773,0.663716814159,38,0.163090128755,75,0.321888412017
411,224,91,0.40625,0.626373626374,34,0.151785714286,57,0.254464285714
412,232,107,0.461206896552,0.607476635514,42,0.181034482759,65,0.280172413793
413,232,117,0.504310344828,0.641025641026,42,0.181034482759,75,0.323275862069
414,234,109,0.465811965812,0.614678899083,42,0.179487179487,67,0.286324786325
415,227,114,0.502202643172,0.640350877193,41,0.180616740088,73,0.321585903084
416,235,115,0.489361702128,0.626086956522,43,0.182978723404,72,0.306382978723
417,230,113,0.491304347826,0.70796460177,33,0.14347826087,80,0.347826086957
418,245,112,0.457142857143,0.642857142857,40,0.163265306122,72,0.29387755102
419,230,110,0.478260869565,0.554545454545,49,0.213043478261,61,0.265217391304
420,242,113,0.46694214876,0.654867256637,39,0.161157024793,74,0.305785123967
421,216,96,0.444444444444,0.760416666667,23,0.106481481481,73,0.337962962963
422,201,88,0.437810945274,0.647727272727,31,0.154228855721,57,0.283582089552
423,210,95,0.452380952381,0.6,38,0.180952380952,57,0.271428571429
424,231,100,0.4329004329,0.55,45,0.194805194805,55,0.238095238095
425,197,92,0.467005076142,0.586956521739,38,0.192893401015,54,0.274111675127
426,209,95,0.454545454545,0.747368421053,24,0.114832535885,71,0.33971291866
427,212,103,0.485849056604,0.708737864078,30,0.141509433962,73,0.344339622642
428,214,93,0.434579439252,0.645161290323,33,0.154205607477,60,0.280373831776
429,198,94,0.474747474747,0.691489361702,29,0.146464646465,65,0.328282828283
430,179,76,0.424581005587,0.723684210526,21,0.117318435754,55,0.307262569832
431,215,116,0.539534883721,0.629310344828,43,0.2,73,0.339534883721
432,214,105,0.490654205607,0.790476190476,22,0.102803738318,83,0.38785046729
433,210,90,0.428571428571,0.633333333333,33,0.157142857143,57,0.271428571429
434,206,105,0.509708737864,0.552380952381,47,0.228155339806,58,0.281553398058
435,179,77,0.430167597765,0.675324675325,25,0.139664804469,52,0.290502793296
436,217,105,0.483870967742,0.580952380952,44,0.202764976959,61,0.281105990783
437,197,103,0.522842639594,0.572815533981,44,0.223350253807,59,0.299492385787
438,186,88,0.47311827957,0.636363636364,32,0.172043010753,56,0.301075268817
439,200,103,0.515,0.611650485437,40,0.2,63,0.315
440,214,94,0.439252336449,0.627659574468,35,0.163551401869,59,0.275700934579
441,190,100,0.526315789474,0.74,26,0.136842105263,74,0.389473684211
442,171,73,0.426900584795,0.643835616438,26,0.152046783626,47,0.27485380117
443,171,80,0.46783625731,0.7,24,0.140350877193,56,0.327485380117
444,180,83,0.461111111111,0.614457831325,32,0.177777777778,51,0.283333333333
445,178,75,0.421348314607,0.706666666667,22,0.123595505618,53,0.297752808989
446,205,101,0.492682926829,0.673267326733,33,0.160975609756,68,0.331707317073
447,192,96,0.5,0.614583333333,37,0.192708333333,59,0.307291666667
448,198,87,0.439393939394,0.724137931034,24,0.121212121212,63,0.318181818182
449,165,86,0.521212121212,0.697674418605,26,0.157575757576,60,0.363636363636
450,181,84,0.46408839779,0.630952380952,31,0.171270718232,53,0.292817679558
451,175,93,0.531428571429,0.655913978495,32,0.182857142857,61,0.348571428571
452,177,86,0.485875706215,0.697674418605,26,0.146892655367,60,0.338983050847
453,156,75,0.480769230769,0.706666666667,22,0.141025641026,53,0.339743589744
454,217,106,0.488479262673,0.660377358491,36,0.165898617512,70,0.322580645161
455,176,100,0.568181818182,0.71,29,0.164772727273,71,0.403409090909
456,175,84,0.48,0.714285714286,24,0.137142857143,60,0.342857142857
457,174,79,0.454022988506,0.696202531646,24,0.137931034483,55,0.316091954023
458,158,74,0.46835443038,0.621621621622,28,0.177215189873,46,0.291139240506
459,158,85,0.537974683544,0.682352941176,27,0.170886075949,58,0.367088607595
460,155,78,0.503225806452,0.602564102564,31,0.2,47,0.303225806452
461,179,92,0.513966480447,0.663043478261,31,0.173184357542,61,0.340782122905
462,191,107,0.560209424084,0.644859813084,38,0.198952879581,69,0.361256544503
463,165,83,0.50303030303,0.686746987952,26,0.157575757576,57,0.345454545455
464,181,84,0.46408839779,0.690476190476,26,0.14364640884,58,0.32044198895
465,169,81,0.479289940828,0.740740740741,21,0.12426035503,60,0.355029585799
466,150,81,0.54,0.567901234568,35,0.233333333333,46,0.306666666667
467,154,74,0.480519480519,0.635135135135,27,0.175324675325,47,0.305194805195
468,178,84,0.47191011236,0.654761904762,29,0.162921348315,55,0.308988764045
469,148,66,0.445945945946,0.742424242424,17,0.114864864865,49,0.331081081081
470,161,80,0.496894409938,0.6125,31,0.192546583851,49,0.304347826087
471,166,85,0.512048192771,0.588235294118,35,0.210843373494,50,0.301204819277
472,184,85,0.461956521739,0.705882352941,25,0.135869565217,60,0.326086956522
473,158,80,0.506329113924,0.6625,27,0.170886075949,53,0.335443037975
474,172,93,0.540697674419,0.655913978495,32,0.186046511628,61,0.354651162791
475,151,78,0.516556291391,0.628205128205,29,0.192052980132,49,0.324503311258
476,171,86,0.502923976608,0.697674418605,26,0.152046783626,60,0.350877192982
477,155,79,0.509677419355,0.582278481013,33,0.212903225806,46,0.296774193548
478,147,72,0.489795918367,0.722222222222,20,0.136054421769,52,0.353741496599
479,155,67,0.432258064516,0.746268656716,17,0.109677419355,50,0.322580645161
480,142,71,0.5,0.732394366197,19,0.133802816901,52,0.366197183099
481,145,68,0.468965517241,0.75,17,0.11724137931,51,0.351724137931
482,161,71,0.44099378882,0.577464788732,30,0.186335403727,41,0.254658385093
483,122,68,0.55737704918,0.705882352941,20,0.16393442623,48,0.393442622951
484,150,84,0.56,0.642857142857,30,0.2,54,0.36
485,135,65,0.481481481481,0.630769230769,24,0.177777777778,41,0.303703703704
486,140,68,0.485714285714,0.705882352941,20,0.142857142857,48,0.342857142857
487,164,73,0.44512195122,0.684931506849,23,0.140243902439,50,0.30487804878
488,144,66,0.458333333333,0.666666666667,22,0.152777777778,44,0.305555555556
489,135,73,0.540740740741,0.630136986301,27,0.2,46,0.340740740741
490,158,82,0.518987341772,0.646341463415,29,0.183544303797,53,0.335443037975
491,136,66,0.485294117647,0.651515151515,23,0.169117647059,43,0.316176470588
492,148,70,0.472972972973,0.614285714286,27,0.182432432432,43,0.290540540541
493,157,79,0.503184713376,0.607594936709,31,0.197452229299,48,0.305732484076
494,128,62,0.484375,0.612903225806,24,0.1875,38,0.296875
495,131,69,0.526717557252,0.652173913043,24,0.18320610687,45,0.343511450382
496,128,70,0.546875,0.571428571429,30,0.234375,40,0.3125
497,136,71,0.522058823529,0.647887323944,25,0.183823529412,46,0.338235294118
498,131,63,0.480916030534,0.555555555556,28,0.213740458015,35,0.267175572519
499,126,60,0.47619047619,0.666666666667,20,0.15873015873,40,0.31746031746
500,160,72,0.45,0.736111111111,19,0.11875,53,0.33125
501,126,67,0.531746031746,0.701492537313,20,0.15873015873,47,0.373015873016
502,120,53,0.441666666667,0.716981132075,15,0.125,38,0.316666666667
503,125,67,0.536,0.65671641791,23,0.184,44,0.352
504,111,59,0.531531531532,0.661016949153,20,0.18018018018,39,0.351351351351
505,138,72,0.521739130435,0.694444444444,22,0.159420289855,50,0.36231884058
506,143,75,0.524475524476,0.76,18,0.125874125874,57,0.398601398601
507,134,71,0.529850746269,0.760563380282,17,0.126865671642,54,0.402985074627
508,127,59,0.464566929134,0.627118644068,22,0.173228346457,37,0.291338582677
509,114,54,0.473684210526,0.62962962963,20,0.175438596491,34,0.298245614035
510,119,55,0.46218487395,0.6,22,0.18487394958,33,0.27731092437
511,111,64,0.576576576577,0.640625,23,0.207207207207,41,0.369369369369
512,138,75,0.54347826087,0.693333333333,23,0.166666666667,52,0.376811594203
513,123,66,0.536585365854,0.575757575758,28,0.227642276423,38,0.308943089431
514,104,50,0.480769230769,0.72,14,0.134615384615,36,0.346153846154
515,119,58,0.487394957983,0.689655172414,18,0.151260504202,40,0.336134453782
516,114,61,0.535087719298,0.754098360656,15,0.131578947368,46,0.40350877193
517,112,56,0.5,0.696428571429,17,0.151785714286,39,0.348214285714
518,117,55,0.470085470085,0.636363636364,20,0.17094017094,35,0.299145299145
519,116,65,0.560344827586,0.661538461538,22,0.189655172414,43,0.370689655172
520,120,62,0.516666666667,0.661290322581,21,0.175,41,0.341666666667
521,123,59,0.479674796748,0.762711864407,14,0.113821138211,45,0.365853658537
522,110,54,0.490909090909,0.666666666667,18,0.163636363636,36,0.327272727273
523,117,57,0.487179487179,0.614035087719,22,0.188034188034,35,0.299145299145
524,136,63,0.463235294118,0.587301587302,26,0.191176470588,37,0.272058823529
525,93,38,0.408602150538,0.657894736842,13,0.139784946237,25,0.268817204301
526,110,66,0.6,0.69696969697,20,0.181818181818,46,0.418181818182
527,126,75,0.595238095238,0.666666666667,25,0.198412698413,50,0.396825396825
528,131,58,0.442748091603,0.689655172414,18,0.137404580153,40,0.30534351145
529,115,44,0.382608695652,0.590909090909,18,0.15652173913,26,0.226086956522
530,115,59,0.513043478261,0.677966101695,19,0.165217391304,40,0.347826086957
531,108,58,0.537037037037,0.741379310345,15,0.138888888889,43,0.398148148148
532,122,67,0.549180327869,0.671641791045,22,0.180327868852,45,0.368852459016
533,113,64,0.566371681416,0.6875,20,0.176991150442,44,0.389380530973
534,106,47,0.443396226415,0.595744680851,19,0.179245283019,28,0.264150943396
535,101,57,0.564356435644,0.719298245614,16,0.158415841584,41,0.405940594059
536,100,55,0.55,0.745454545455,14,0.14,41,0.41
537,108,51,0.472222222222,0.745098039216,13,0.12037037037,38,0.351851851852
538,112,60,0.535714285714,0.566666666667,26,0.232142857143,34,0.303571428571
539,125,64,0.512,0.671875,21,0.168,43,0.344
540,126,62,0.492063492063,0.709677419355,18,0.142857142857,44,0.349206349206
541,90,49,0.544444444444,0.632653061224,18,0.2,31,0.344444444444
542,100,50,0.5,0.68,16,0.16,34,0.34
543,105,55,0.52380952381,0.618181818182,21,0.2,34,0.32380952381
544,91,48,0.527472527473,0.708333333333,14,0.153846153846,34,0.373626373626
545,108,56,0.518518518519,0.678571428571,18,0.166666666667,38,0.351851851852
546,90,40,0.444444444444,0.7,12,0.133333333333,28,0.311111111111
547,102,53,0.519607843137,0.603773584906,21,0.205882352941,32,0.313725490196
548,97,49,0.505154639175,0.816326530612,9,0.0927835051546,40,0.412371134021
549,98,50,0.510204081633,0.66,17,0.173469387755,33,0.336734693878
550,101,51,0.50495049505,0.666666666667,17,0.168316831683,34,0.336633663366
551,106,56,0.528301886792,0.589285714286,23,0.216981132075,33,0.311320754717
552,100,48,0.48,0.666666666667,16,0.16,32,0.32
553,116,60,0.51724137931,0.7,18,0.155172413793,42,0.362068965517
554,89,56,0.629213483146,0.732142857143,15,0.168539325843,41,0.460674157303
555,89,42,0.47191011236,0.833333333333,7,0.0786516853933,35,0.393258426966
556,90,50,0.555555555556,0.78,11,0.122222222222,39,0.433333333333
557,107,57,0.532710280374,0.754385964912,14,0.130841121495,43,0.401869158879
558,81,37,0.456790123457,0.756756756757,9,0.111111111111,28,0.345679012346
559,100,37,0.37,0.783783783784,8,0.08,29,0.29
560,88,42,0.477272727273,0.666666666667,14,0.159090909091,28,0.318181818182
561,90,48,0.533333333333,0.729166666667,13,0.144444444444,35,0.388888888889
562,80,33,0.4125,0.727272727273,9,0.1125,24,0.3
563,103,52,0.504854368932,0.653846153846,18,0.174757281553,34,0.330097087379
564,93,42,0.451612903226,0.595238095238,17,0.182795698925,25,0.268817204301
565,79,39,0.493670886076,0.615384615385,15,0.189873417722,24,0.303797468354
566,77,39,0.506493506494,0.820512820513,7,0.0909090909091,32,0.415584415584
567,79,50,0.632911392405,0.56,22,0.278481012658,28,0.354430379747
568,82,33,0.40243902439,0.848484848485,5,0.0609756097561,28,0.341463414634
569,82,38,0.463414634146,0.5,19,0.231707317073,19,0.231707317073
570,96,53,0.552083333333,0.641509433962,19,0.197916666667,34,0.354166666667
571,89,49,0.550561797753,0.69387755102,15,0.168539325843,34,0.38202247191
572,89,42,0.47191011236,0.833333333333,7,0.0786516853933,35,0.393258426966
573,97,50,0.515463917526,0.72,14,0.144329896907,36,0.371134020619
574,86,46,0.53488372093,0.673913043478,15,0.174418604651,31,0.360465116279
575,85,49,0.576470588235,0.755102040816,12,0.141176470588,37,0.435294117647
576,89,45,0.505617977528,0.777777777778,10,0.112359550562,35,0.393258426966
577,94,57,0.606382978723,0.649122807018,20,0.212765957447,37,0.393617021277
578,92,46,0.5,0.673913043478,15,0.163043478261,31,0.336956521739
579,80,45,0.5625,0.711111111111,13,0.1625,32,0.4
580,93,58,0.623655913978,0.637931034483,21,0.225806451613,37,0.397849462366
581,85,43,0.505882352941,0.581395348837,18,0.211764705882,25,0.294117647059
582,81,44,0.543209876543,0.704545454545,13,0.16049382716,31,0.382716049383
583,83,49,0.590361445783,0.816326530612,9,0.10843373494,40,0.481927710843
584,91,39,0.428571428571,0.692307692308,12,0.131868131868,27,0.296703296703
585,94,44,0.468085106383,0.636363636364,16,0.170212765957,28,0.297872340426
586,72,42,0.583333333333,0.690476190476,13,0.180555555556,29,0.402777777778
587,83,36,0.433734939759,0.638888888889,13,0.156626506024,23,0.277108433735
588,94,33,0.351063829787,0.69696969697,10,0.106382978723,23,0.244680851064
589,81,44,0.543209876543,0.659090909091,15,0.185185185185,29,0.358024691358
590,83,46,0.55421686747,0.695652173913,14,0.168674698795,32,0.385542168675
591,91,51,0.56043956044,0.78431372549,11,0.120879120879,40,0.43956043956
592,84,46,0.547619047619,0.608695652174,18,0.214285714286,28,0.333333333333
593,82,41,0.5,0.658536585366,14,0.170731707317,27,0.329268292683
594,88,42,0.477272727273,0.619047619048,16,0.181818181818,26,0.295454545455
595,73,32,0.438356164384,0.6875,10,0.13698630137,22,0.301369863014
596,78,41,0.525641025641,0.707317073171,12,0.153846153846,29,0.371794871795
597,90,47,0.522222222222,0.872340425532,6,0.0666666666667,41,0.455555555556
598,88,42,0.477272727273,0.761904761905,10,0.113636363636,32,0.363636363636
599,85,46,0.541176470588,0.652173913043,16,0.188235294118,30,0.352941176471
600,74,36,0.486486486486,0.555555555556,16,0.216216216216,20,0.27027027027
601,88,43,0.488636363636,0.674418604651,14,0.159090909091,29,0.329545454545
602,69,42,0.608695652174,0.642857142857,15,0.217391304348,27,0.391304347826
603,85,49,0.576470588235,0.612244897959,19,0.223529411765,30,0.352941176471
604,83,41,0.493975903614,0.634146341463,15,0.180722891566,26,0.313253012048
605,84,42,0.5,0.738095238095,11,0.130952380952,31,0.369047619048
606,76,38,0.5,0.657894736842,13,0.171052631579,25,0.328947368421
607,69,37,0.536231884058,0.72972972973,10,0.144927536232,27,0.391304347826
608,81,50,0.617283950617,0.64,18,0.222222222222,32,0.395061728395
609,70,33,0.471428571429,0.787878787879,7,0.1,26,0.371428571429
610,77,51,0.662337662338,0.56862745098,22,0.285714285714,29,0.376623376623
611,66,29,0.439393939394,0.655172413793,10,0.151515151515,19,0.287878787879
612,59,34,0.576271186441,0.647058823529,12,0.203389830508,22,0.372881355932
613,70,40,0.571428571429,0.6,16,0.228571428571,24,0.342857142857
614,67,38,0.567164179104,0.789473684211,8,0.119402985075,30,0.44776119403
615,78,38,0.487179487179,0.763157894737,9,0.115384615385,29,0.371794871795
616,57,33,0.578947368421,0.666666666667,11,0.19298245614,22,0.385964912281
617,57,35,0.614035087719,0.571428571429,15,0.263157894737,20,0.350877192982
618,46,25,0.54347826087,0.68,8,0.173913043478,17,0.369565217391
619,66,38,0.575757575758,0.684210526316,12,0.181818181818,26,0.393939393939
620,63,28,0.444444444444,0.678571428571,9,0.142857142857,19,0.301587301587
621,71,41,0.577464788732,0.731707317073,11,0.154929577465,30,0.422535211268
622,59,32,0.542372881356,0.6875,10,0.169491525424,22,0.372881355932
623,64,34,0.53125,0.764705882353,8,0.125,26,0.40625
624,70,36,0.514285714286,0.666666666667,12,0.171428571429,24,0.342857142857
625,67,40,0.597014925373,0.7,12,0.179104477612,28,0.417910447761
626,60,27,0.45,0.592592592593,11,0.183333333333,16,0.266666666667
627,69,42,0.608695652174,0.595238095238,17,0.246376811594,25,0.36231884058
628,62,28,0.451612903226,0.75,7,0.112903225806,21,0.338709677419
629,65,34,0.523076923077,0.705882352941,10,0.153846153846,24,0.369230769231
630,73,40,0.547945205479,0.6,16,0.219178082192,24,0.328767123288
631,59,28,0.474576271186,0.571428571429,12,0.203389830508,16,0.271186440678
632,71,35,0.492957746479,0.542857142857,16,0.225352112676,19,0.267605633803
633,69,40,0.579710144928,0.65,14,0.202898550725,26,0.376811594203
634,68,35,0.514705882353,0.657142857143,12,0.176470588235,23,0.338235294118
635,60,27,0.45,0.666666666667,9,0.15,18,0.3
636,72,38,0.527777777778,0.736842105263,10,0.138888888889,28,0.388888888889
637,64,34,0.53125,0.764705882353,8,0.125,26,0.40625
638,63,33,0.52380952381,0.69696969697,10,0.15873015873,23,0.365079365079
639,75,41,0.546666666667,0.682926829268,13,0.173333333333,28,0.373333333333
640,69,33,0.478260869565,0.666666666667,11,0.159420289855,22,0.31884057971
641,58,28,0.48275862069,0.785714285714,6,0.103448275862,22,0.379310344828
642,80,45,0.5625,0.733333333333,12,0.15,33,0.4125
643,64,33,0.515625,0.727272727273,9,0.140625,24,0.375
644,50,26,0.52,0.653846153846,9,0.18,17,0.34
645,62,28,0.451612903226,0.642857142857,10,0.161290322581,18,0.290322580645
646,50,29,0.58,0.689655172414,9,0.18,20,0.4
647,56,29,0.517857142857,0.793103448276,6,0.107142857143,23,0.410714285714
648,59,34,0.576271186441,0.588235294118,14,0.237288135593,20,0.338983050847
649,50,28,0.56,0.5,14,0.28,14,0.28
650,41,22,0.536585365854,0.818181818182,4,0.0975609756098,18,0.439024390244
651,67,33,0.492537313433,0.727272727273,9,0.134328358209,24,0.358208955224
652,54,28,0.518518518519,0.642857142857,10,0.185185185185,18,0.333333333333
653,61,34,0.55737704918,0.647058823529,12,0.196721311475,22,0.360655737705
654,71,40,0.56338028169,0.625,15,0.211267605634,25,0.352112676056
655,60,27,0.45,0.740740740741,7,0.116666666667,20,0.333333333333
656,61,33,0.540983606557,0.606060606061,13,0.213114754098,20,0.327868852459
657,49,27,0.551020408163,0.703703703704,8,0.163265306122,19,0.387755102041
658,50,27,0.54,0.62962962963,10,0.2,17,0.34
659,51,26,0.509803921569,0.615384615385,10,0.196078431373,16,0.313725490196
660,62,33,0.532258064516,0.666666666667,11,0.177419354839,22,0.354838709677
661,63,32,0.507936507937,0.78125,7,0.111111111111,25,0.396825396825
662,64,27,0.421875,0.666666666667,9,0.140625,18,0.28125
663,53,24,0.452830188679,0.666666666667,8,0.150943396226,16,0.301886792453
664,53,26,0.490566037736,0.576923076923,11,0.207547169811,15,0.283018867925
665,59,33,0.559322033898,0.818181818182,6,0.101694915254,27,0.457627118644
666,64,31,0.484375,0.838709677419,5,0.078125,26,0.40625
667,58,30,0.51724137931,0.666666666667,10,0.172413793103,20,0.344827586207
668,58,35,0.603448275862,0.571428571429,15,0.258620689655,20,0.344827586207
669,36,15,0.416666666667,0.8,3,0.0833333333333,12,0.333333333333
670,45,29,0.644444444444,0.724137931034,8,0.177777777778,21,0.466666666667
671,53,24,0.452830188679,0.791666666667,5,0.0943396226415,19,0.358490566038
672,54,27,0.5,0.518518518519,13,0.240740740741,14,0.259259259259
673,51,30,0.588235294118,0.766666666667,7,0.137254901961,23,0.450980392157
674,58,32,0.551724137931,0.71875,9,0.155172413793,23,0.396551724138
675,61,31,0.508196721311,0.774193548387,7,0.114754098361,24,0.393442622951
676,49,29,0.591836734694,0.586206896552,12,0.244897959184,17,0.34693877551
677,54,21,0.388888888889,0.428571428571,12,0.222222222222,9,0.166666666667
678,55,29,0.527272727273,0.655172413793,10,0.181818181818,19,0.345454545455
679,47,22,0.468085106383,0.681818181818,7,0.148936170213,15,0.31914893617
680,60,27,0.45,0.777777777778,6,0.1,21,0.35
681,45,21,0.466666666667,0.714285714286,6,0.133333333333,15,0.333333333333
682,62,32,0.516129032258,0.625,12,0.193548387097,20,0.322580645161
683,43,20,0.46511627907,0.55,9,0.209302325581,11,0.255813953488
684,54,25,0.462962962963,0.8,5,0.0925925925926,20,0.37037037037
685,60,31,0.516666666667,0.741935483871,8,0.133333333333,23,0.383333333333
686,60,24,0.4,0.666666666667,8,0.133333333333,16,0.266666666667
687,41,18,0.439024390244,0.777777777778,4,0.0975609756098,14,0.341463414634
688,58,29,0.5,0.793103448276,6,0.103448275862,23,0.396551724138
689,53,29,0.547169811321,0.793103448276,6,0.11320754717,23,0.433962264151
690,56,26,0.464285714286,0.692307692308,8,0.142857142857,18,0.321428571429
691,45,28,0.622222222222,0.607142857143,11,0.244444444444,17,0.377777777778
692,57,27,0.473684210526,0.592592592593,11,0.19298245614,16,0.280701754386
693,48,25,0.520833333333,0.64,9,0.1875,16,0.333333333333
694,39,23,0.589743589744,0.652173913043,8,0.205128205128,15,0.384615384615
695,48,22,0.458333333333,0.727272727273,6,0.125,16,0.333333333333
696,45,19,0.422222222222,0.842105263158,3,0.0666666666667,16,0.355555555556
697,43,24,0.558139534884,0.458333333333,13,0.302325581395,11,0.255813953488
698,48,23,0.479166666667,0.869565217391,3,0.0625,20,0.416666666667
699,53,29,0.547169811321,0.689655172414,9,0.169811320755,20,0.377358490566
700,58,35,0.603448275862,0.742857142857,9,0.155172413793,26,0.448275862069
701,53,23,0.433962264151,0.652173913043,8,0.150943396226,15,0.283018867925
702,51,26,0.509803921569,0.807692307692,5,0.0980392156863,21,0.411764705882
703,36,18,0.5,0.944444444444,1,0.0277777777778,17,0.472222222222
704,60,40,0.666666666667,0.8,8,0.133333333333,32,0.533333333333
705,40,23,0.575,0.652173913043,8,0.2,15,0.375
706,46,19,0.413043478261,0.842105263158,3,0.0652173913043,16,0.347826086957
707,40,18,0.45,0.777777777778,4,0.1,14,0.35
708,43,19,0.441860465116,0.473684210526,10,0.232558139535,9,0.209302325581
709,34,17,0.5,0.647058823529,6,0.176470588235,11,0.323529411765
710,49,28,0.571428571429,0.678571428571,9,0.183673469388,19,0.387755102041
711,47,23,0.489361702128,0.652173913043,8,0.170212765957,15,0.31914893617
712,45,28,0.622222222222,0.75,7,0.155555555556,21,0.466666666667
713,41,22,0.536585365854,0.863636363636,3,0.0731707317073,19,0.463414634146
714,38,20,0.526315789474,0.85,3,0.0789473684211,17,0.447368421053
715,47,29,0.617021276596,0.620689655172,11,0.234042553191,18,0.382978723404
716,40,20,0.5,0.6,8,0.2,12,0.3
717,49,20,0.408163265306,0.9,2,0.0408163265306,18,0.367346938776
718,40,21,0.525,0.857142857143,3,0.075,18,0.45
719,36,20,0.555555555556,0.7,6,0.166666666667,14,0.388888888889
720,46,28,0.608695652174,0.75,7,0.152173913043,21,0.45652173913
721,28,15,0.535714285714,0.533333333333,7,0.25,8,0.285714285714
722,31,11,0.354838709677,0.727272727273,3,0.0967741935484,8,0.258064516129
723,44,23,0.522727272727,0.695652173913,7,0.159090909091,16,0.363636363636
724,40,23,0.575,0.782608695652,5,0.125,18,0.45
725,41,25,0.609756097561,0.52,12,0.292682926829,13,0.317073170732
726,36,20,0.555555555556,0.65,7,0.194444444444,13,0.361111111111
727,30,13,0.433333333333,0.923076923077,1,0.0333333333333,12,0.4
728,43,24,0.558139534884,0.75,6,0.139534883721,18,0.418604651163
729,44,23,0.522727272727,0.478260869565,12,0.272727272727,11,0.25
730,46,30,0.652173913043,0.666666666667,10,0.217391304348,20,0.434782608696
731,39,17,0.435897435897,0.705882352941,5,0.128205128205,12,0.307692307692
732,52,25,0.480769230769,0.88,3,0.0576923076923,22,0.423076923077
733,41,25,0.609756097561,0.6,10,0.243902439024,15,0.365853658537
734,38,20,0.526315789474,0.9,2,0.0526315789474,18,0.473684210526
735,48,25,0.520833333333,0.8,5,0.104166666667,20,0.416666666667
736,37,16,0.432432432432,0.6875,5,0.135135135135,11,0.297297297297
737,40,20,0.5,0.65,7,0.175,13,0.325
738,30,15,0.5,0.666666666667,5,0.166666666667,10,0.333333333333
739,47,23,0.489361702128,0.652173913043,8,0.170212765957,15,0.31914893617
740,35,16,0.457142857143,0.8125,3,0.0857142857143,13,0.371428571429
741,40,25,0.625,0.8,5,0.125,20,0.5
742,33,17,0.515151515152,0.764705882353,4,0.121212121212,13,0.393939393939
743,41,19,0.463414634146,0.578947368421,8,0.19512195122,11,0.268292682927
744,33,17,0.515151515152,0.705882352941,5,0.151515151515,12,0.363636363636
745,42,22,0.52380952381,0.545454545455,10,0.238095238095,12,0.285714285714
746,29,15,0.51724137931,0.6,6,0.206896551724,9,0.310344827586
747,40,18,0.45,0.833333333333,3,0.075,15,0.375
748,36,15,0.416666666667,0.8,3,0.0833333333333,12,0.333333333333
749,36,21,0.583333333333,0.809523809524,4,0.111111111111,17,0.472222222222
750,46,29,0.630434782609,0.655172413793,10,0.217391304348,19,0.413043478261
751,32,18,0.5625,0.722222222222,5,0.15625,13,0.40625
752,35,21,0.6,0.761904761905,5,0.142857142857,16,0.457142857143
753,41,21,0.512195121951,0.809523809524,4,0.0975609756098,17,0.414634146341
754,48,18,0.375,0.666666666667,6,0.125,12,0.25
755,42,20,0.47619047619,0.65,7,0.166666666667,13,0.309523809524
756,28,14,0.5,0.571428571429,6,0.214285714286,8,0.285714285714
757,32,18,0.5625,0.722222222222,5,0.15625,13,0.40625
758,38,21,0.552631578947,0.809523809524,4,0.105263157895,17,0.447368421053
759,40,25,0.625,0.68,8,0.2,17,0.425
760,34,19,0.558823529412,0.789473684211,4,0.117647058824,15,0.441176470588
761,40,21,0.525,0.619047619048,8,0.2,13,0.325
762,31,13,0.41935483871,0.692307692308,4,0.129032258065,9,0.290322580645
763,36,15,0.416666666667,0.866666666667,2,0.0555555555556,13,0.361111111111
764,31,13,0.41935483871,0.692307692308,4,0.129032258065,9,0.290322580645
765,39,19,0.487179487179,0.842105263158,3,0.0769230769231,16,0.410256410256
766,30,13,0.433333333333,0.769230769231,3,0.1,10,0.333333333333
767,29,14,0.48275862069,0.785714285714,3,0.103448275862,11,0.379310344828
768,35,20,0.571428571429,0.8,4,0.114285714286,16,0.457142857143
769,36,22,0.611111111111,0.681818181818,7,0.194444444444,15,0.416666666667
770,33,15,0.454545454545,0.6,6,0.181818181818,9,0.272727272727
771,26,14,0.538461538462,0.785714285714,3,0.115384615385,11,0.423076923077
772,32,18,0.5625,0.611111111111,7,0.21875,11,0.34375
773,33,22,0.666666666667,0.818181818182,4,0.121212121212,18,0.545454545455
774,30,19,0.633333333333,0.736842105263,5,0.166666666667,14,0.466666666667
775,33,19,0.575757575758,0.789473684211,4,0.121212121212,15,0.454545454545
776,42,23,0.547619047619,0.565217391304,10,0.238095238095,13,0.309523809524
777,33,19,0.575757575758,0.842105263158,3,0.0909090909091,16,0.484848484848
778,32,17,0.53125,0.764705882353,4,0.125,13,0.40625
779,33,19,0.575757575758,0.631578947368,7,0.212121212121,12,0.363636363636
780,40,21,0.525,0.666666666667,7,0.175,14,0.35
781,34,18,0.529411764706,0.666666666667,6,0.176470588235,12,0.352941176471
782,33,15,0.454545454545,0.666666666667,5,0.151515151515,10,0.30303030303
783,33,17,0.515151515152,0.411764705882,10,0.30303030303,7,0.212121212121
784,28,17,0.607142857143,0.882352941176,2,0.0714285714286,15,0.535714285714
785,30,21,0.7,0.809523809524,4,0.133333333333,17,0.566666666667
786,32,21,0.65625,0.714285714286,6,0.1875,15,0.46875
787,27,17,0.62962962963,0.882352941176,2,0.0740740740741,15,0.555555555556
788,38,21,0.552631578947,0.714285714286,6,0.157894736842,15,0.394736842105
789,26,14,0.538461538462,0.5,7,0.269230769231,7,0.269230769231
790,28,10,0.357142857143,0.8,2,0.0714285714286,8,0.285714285714
791,31,19,0.612903225806,0.631578947368,7,0.225806451613,12,0.387096774194
792,42,20,0.47619047619,0.65,7,0.166666666667,13,0.309523809524
793,35,15,0.428571428571,0.666666666667,5,0.142857142857,10,0.285714285714
794,25,15,0.6,0.666666666667,5,0.2,10,0.4
795,35,17,0.485714285714,0.647058823529,6,0.171428571429,11,0.314285714286
796,33,18,0.545454545455,0.944444444444,1,0.030303030303,17,0.515151515152
797,26,9,0.346153846154,0.444444444444,5,0.192307692308,4,0.153846153846
798,40,21,0.525,0.52380952381,10,0.25,11,0.275
799,27,20,0.740740740741,0.65,7,0.259259259259,13,0.481481481481
800,30,12,0.4,0.666666666667,4,0.133333333333,8,0.266666666667
801,23,15,0.652173913043,0.8,3,0.130434782609,12,0.521739130435
802,35,21,0.6,0.714285714286,6,0.171428571429,15,0.428571428571
803,28,15,0.535714285714,0.933333333333,1,0.0357142857143,14,0.5
804,34,20,0.588235294118,0.65,7,0.205882352941,13,0.382352941176
805,26,16,0.615384615385,0.4375,9,0.346153846154,7,0.269230769231
806,20,10,0.5,0.5,5,0.25,5,0.25
807,27,18,0.666666666667,0.888888888889,2,0.0740740740741,16,0.592592592593
808,36,16,0.444444444444,0.6875,5,0.138888888889,11,0.305555555556
809,28,12,0.428571428571,0.916666666667,1,0.0357142857143,11,0.392857142857
810,26,11,0.423076923077,0.818181818182,2,0.0769230769231,9,0.346153846154
811,20,15,0.75,1.0,0,0.0,15,0.75
812,26,12,0.461538461538,0.666666666667,4,0.153846153846,8,0.307692307692
813,30,19,0.633333333333,0.789473684211,4,0.133333333333,15,0.5
814,31,21,0.677419354839,0.809523809524,4,0.129032258065,17,0.548387096774
815,25,13,0.52,0.769230769231,3,0.12,10,0.4
816,30,17,0.566666666667,0.705882352941,5,0.166666666667,12,0.4
817,30,16,0.533333333333,0.6875,5,0.166666666667,11,0.366666666667
818,34,23,0.676470588235,0.695652173913,7,0.205882352941,16,0.470588235294
819,29,14,0.48275862069,0.571428571429,6,0.206896551724,8,0.275862068966
820,23,10,0.434782608696,0.4,6,0.260869565217,4,0.173913043478
821,29,17,0.586206896552,0.647058823529,6,0.206896551724,11,0.379310344828
822,30,18,0.6,0.722222222222,5,0.166666666667,13,0.433333333333
823,20,14,0.7,0.857142857143,2,0.1,12,0.6
824,20,12,0.6,0.916666666667,1,0.05,11,0.55
825,30,14,0.466666666667,0.571428571429,6,0.2,8,0.266666666667
826,26,19,0.730769230769,0.631578947368,7,0.269230769231,12,0.461538461538
827,25,11,0.44,0.727272727273,3,0.12,8,0.32
828,38,22,0.578947368421,0.772727272727,5,0.131578947368,17,0.447368421053
829,33,18,0.545454545455,0.722222222222,5,0.151515151515,13,0.393939393939
830,19,14,0.736842105263,0.928571428571,1,0.0526315789474,13,0.684210526316
831,22,11,0.5,0.636363636364,4,0.181818181818,7,0.318181818182
832,29,15,0.51724137931,0.666666666667,5,0.172413793103,10,0.344827586207
833,30,13,0.433333333333,0.615384615385,5,0.166666666667,8,0.266666666667
834,30,16,0.533333333333,0.6875,5,0.166666666667,11,0.366666666667
835,27,20,0.740740740741,0.7,6,0.222222222222,14,0.518518518519
836,26,14,0.538461538462,0.785714285714,3,0.115384615385,11,0.423076923077
837,20,13,0.65,0.692307692308,4,0.2,9,0.45
838,31,18,0.58064516129,0.611111111111,7,0.225806451613,11,0.354838709677
839,28,13,0.464285714286,0.846153846154,2,0.0714285714286,11,0.392857142857
840,19,11,0.578947368421,0.818181818182,2,0.105263157895,9,0.473684210526
841,31,19,0.612903225806,0.789473684211,4,0.129032258065,15,0.483870967742
842,25,14,0.56,0.857142857143,2,0.08,12,0.48
843,27,16,0.592592592593,0.5,8,0.296296296296,8,0.296296296296
844,29,18,0.620689655172,0.611111111111,7,0.241379310345,11,0.379310344828
845,21,15,0.714285714286,0.933333333333,1,0.047619047619,14,0.666666666667
846,24,11,0.458333333333,0.545454545455,5,0.208333333333,6,0.25
847,25,12,0.48,0.666666666667,4,0.16,8,0.32
848,29,14,0.48275862069,0.714285714286,4,0.137931034483,10,0.344827586207
849,17,7,0.411764705882,0.714285714286,2,0.117647058824,5,0.294117647059
850,29,11,0.379310344828,0.636363636364,4,0.137931034483,7,0.241379310345
851,27,14,0.518518518519,0.571428571429,6,0.222222222222,8,0.296296296296
852,22,10,0.454545454545,0.7,3,0.136363636364,7,0.318181818182
853,25,13,0.52,0.461538461538,7,0.28,6,0.24
854,24,15,0.625,0.666666666667,5,0.208333333333,10,0.416666666667
855,20,12,0.6,0.583333333333,5,0.25,7,0.35
856,31,18,0.58064516129,0.833333333333,3,0.0967741935484,15,0.483870967742
857,23,10,0.434782608696,0.9,1,0.0434782608696,9,0.391304347826
858,27,17,0.62962962963,0.529411764706,8,0.296296296296,9,0.333333333333
859,22,11,0.5,0.545454545455,5,0.227272727273,6,0.272727272727
860,24,17,0.708333333333,0.647058823529,6,0.25,11,0.458333333333
861,28,12,0.428571428571,0.75,3,0.107142857143,9,0.321428571429
862,25,14,0.56,0.857142857143,2,0.08,12,0.48
863,18,7,0.388888888889,0.714285714286,2,0.111111111111,5,0.277777777778
864,35,14,0.4,0.714285714286,4,0.114285714286,10,0.285714285714
865,32,19,0.59375,0.842105263158,3,0.09375,16,0.5
866,22,10,0.454545454545,0.9,1,0.0454545454545,9,0.409090909091
867,23,15,0.652173913043,0.933333333333,1,0.0434782608696,14,0.608695652174
868,22,8,0.363636363636,0.625,3,0.136363636364,5,0.227272727273
869,23,14,0.608695652174,0.642857142857,5,0.217391304348,9,0.391304347826
870,20,9,0.45,0.666666666667,3,0.15,6,0.3
871,21,13,0.619047619048,0.615384615385,5,0.238095238095,8,0.380952380952
872,21,13,0.619047619048,0.538461538462,6,0.285714285714,7,0.333333333333
873,21,13,0.619047619048,0.692307692308,4,0.190476190476,9,0.428571428571
874,18,5,0.277777777778,0.6,2,0.111111111111,3,0.166666666667
875,18,13,0.722222222222,0.692307692308,4,0.222222222222,9,0.5
876,22,13,0.590909090909,0.846153846154,2,0.0909090909091,11,0.5
877,26,14,0.538461538462,0.642857142857,5,0.192307692308,9,0.346153846154
878,26,14,0.538461538462,0.642857142857,5,0.192307692308,9,0.346153846154
879,24,14,0.583333333333,0.714285714286,4,0.166666666667,10,0.416666666667
880,23,12,0.521739130435,0.583333333333,5,0.217391304348,7,0.304347826087
881,26,11,0.423076923077,0.636363636364,4,0.153846153846,7,0.269230769231
882,22,12,0.545454545455,0.666666666667,4,0.181818181818,8,0.363636363636
883,30,10,0.333333333333,0.8,2,0.0666666666667,8,0.266666666667
884,23,12,0.521739130435,0.583333333333,5,0.217391304348,7,0.304347826087
885,27,18,0.666666666667,0.666666666667,6,0.222222222222,12,0.444444444444
886,20,10,0.5,0.6,4,0.2,6,0.3
887,18,10,0.555555555556,0.9,1,0.0555555555556,9,0.5
888,26,17,0.653846153846,0.705882352941,5,0.192307692308,12,0.461538461538
889,22,12,0.545454545455,0.833333333333,2,0.0909090909091,10,0.454545454545
890,18,9,0.5,0.666666666667,3,0.166666666667,6,0.333333333333
891,20,12,0.6,0.75,3,0.15,9,0.45
892,18,10,0.555555555556,0.9,1,0.0555555555556,9,0.5
893,27,19,0.703703703704,0.842105263158,3,0.111111111111,16,0.592592592593
894,20,8,0.4,0.75,2,0.1,6,0.3
895,15,5,0.333333333333,0.2,4,0.266666666667,1,0.0666666666667
896,25,10,0.4,0.6,4,0.16,6,0.24
897,20,13,0.65,0.923076923077,1,0.05,12,0.6
898,21,8,0.380952380952,0.75,2,0.0952380952381,6,0.285714285714
899,16,9,0.5625,0.555555555556,4,0.25,5,0.3125
900,20,15,0.75,0.4,9,0.45,6,0.3
901,23,12,0.521739130435,0.833333333333,2,0.0869565217391,10,0.434782608696
902,25,11,0.44,0.909090909091,1,0.04,10,0.4
903,16,5,0.3125,0.6,2,0.125,3,0.1875
904,27,17,0.62962962963,0.705882352941,5,0.185185185185,12,0.444444444444
905,22,12,0.545454545455,0.833333333333,2,0.0909090909091,10,0.454545454545
906,23,16,0.695652173913,0.6875,5,0.217391304348,11,0.478260869565
907,22,10,0.454545454545,0.8,2,0.0909090909091,8,0.363636363636
908,28,18,0.642857142857,0.833333333333,3,0.107142857143,15,0.535714285714
909,14,8,0.571428571429,0.5,4,0.285714285714,4,0.285714285714
910,22,7,0.318181818182,0.857142857143,1,0.0454545454545,6,0.272727272727
911,29,16,0.551724137931,0.6875,5,0.172413793103,11,0.379310344828
912,23,17,0.739130434783,0.823529411765,3,0.130434782609,14,0.608695652174
913,28,17,0.607142857143,0.764705882353,4,0.142857142857,13,0.464285714286
914,17,8,0.470588235294,0.875,1,0.0588235294118,7,0.411764705882
915,24,14,0.583333333333,0.714285714286,4,0.166666666667,10,0.416666666667
916,12,6,0.5,0.5,3,0.25,3,0.25
917,15,9,0.6,0.888888888889,1,0.0666666666667,8,0.533333333333
918,17,5,0.294117647059,0.6,2,0.117647058824,3,0.176470588235
919,14,7,0.5,0.714285714286,2,0.142857142857,5,0.357142857143
920,30,18,0.6,0.888888888889,2,0.0666666666667,16,0.533333333333
921,17,9,0.529411764706,0.666666666667,3,0.176470588235,6,0.352941176471
922,17,10,0.588235294118,0.5,5,0.294117647059,5,0.294117647059
923,14,6,0.428571428571,0.5,3,0.214285714286,3,0.214285714286
924,24,15,0.625,0.666666666667,5,0.208333333333,10,0.416666666667
925,14,8,0.571428571429,0.5,4,0.285714285714,4,0.285714285714
926,20,10,0.5,0.7,3,0.15,7,0.35
927,16,11,0.6875,0.454545454545,6,0.375,5,0.3125
928,18,8,0.444444444444,0.75,2,0.111111111111,6,0.333333333333
929,15,9,0.6,1.0,0,0.0,9,0.6
930,23,16,0.695652173913,1.0,0,0.0,16,0.695652173913
931,21,14,0.666666666667,0.571428571429,6,0.285714285714,8,0.380952380952
932,19,12,0.631578947368,0.916666666667,1,0.0526315789474,11,0.578947368421
933,18,12,0.666666666667,0.583333333333,5,0.277777777778,7,0.388888888889
934,22,12,0.545454545455,0.416666666667,7,0.318181818182,5,0.227272727273
935,12,6,0.5,0.5,3,0.25,3,0.25
936,20,16,0.8,0.8125,3,0.15,13,0.65
937,14,10,0.714285714286,0.8,2,0.142857142857,8,0.571428571429
938,22,15,0.681818181818,0.466666666667,8,0.363636363636,7,0.318181818182
939,14,5,0.357142857143,1.0,0,0.0,5,0.357142857143
940,17,9,0.529411764706,0.888888888889,1,0.0588235294118,8,0.470588235294
941,15,11,0.733333333333,0.909090909091,1,0.0666666666667,10,0.666666666667
942,13,6,0.461538461538,1.0,0,0.0,6,0.461538461538
943,13,6,0.461538461538,0.833333333333,1,0.0769230769231,5,0.384615384615
944,13,11,0.846153846154,0.727272727273,3,0.230769230769,8,0.615384615385
945,13,5,0.384615384615,0.8,1,0.0769230769231,4,0.307692307692
946,19,14,0.736842105263,0.928571428571,1,0.0526315789474,13,0.684210526316
947,20,11,0.55,0.727272727273,3,0.15,8,0.4
948,15,10,0.666666666667,0.6,4,0.266666666667,6,0.4
949,13,8,0.615384615385,0.625,3,0.230769230769,5,0.384615384615
950,12,6,0.5,0.5,3,0.25,3,0.25
951,16,7,0.4375,0.571428571429,3,0.1875,4,0.25
952,22,10,0.454545454545,0.5,5,0.227272727273,5,0.227272727273
953,17,10,0.588235294118,0.8,2,0.117647058824,8,0.470588235294
954,14,8,0.571428571429,0.875,1,0.0714285714286,7,0.5
955,19,9,0.473684210526,0.555555555556,4,0.210526315789,5,0.263157894737
956,21,13,0.619047619048,0.923076923077,1,0.047619047619,12,0.571428571429
957,12,6,0.5,0.333333333333,4,0.333333333333,2,0.166666666667
958,15,8,0.533333333333,0.75,2,0.133333333333,6,0.4
959,14,8,0.571428571429,0.875,1,0.0714285714286,7,0.5
960,18,7,0.388888888889,0.714285714286,2,0.111111111111,5,0.277777777778
961,16,8,0.5,0.75,2,0.125,6,0.375
962,13,8,0.615384615385,0.625,3,0.230769230769,5,0.384615384615
963,15,11,0.733333333333,0.818181818182,2,0.133333333333,9,0.6
964,20,6,0.3,1.0,0,0.0,6,0.3
965,16,9,0.5625,0.777777777778,2,0.125,7,0.4375
966,18,9,0.5,0.888888888889,1,0.0555555555556,8,0.444444444444
967,13,4,0.307692307692,0.75,1,0.0769230769231,3,0.230769230769
968,15,6,0.4,0.333333333333,4,0.266666666667,2,0.133333333333
969,19,9,0.473684210526,0.666666666667,3,0.157894736842,6,0.315789473684
970,20,10,0.5,0.9,1,0.05,9,0.45
971,23,11,0.478260869565,0.636363636364,4,0.173913043478,7,0.304347826087
972,17,12,0.705882352941,0.75,3,0.176470588235,9,0.529411764706
973,14,10,0.714285714286,0.6,4,0.285714285714,6,0.428571428571
974,17,9,0.529411764706,1.0,0,0.0,9,0.529411764706
975,15,4,0.266666666667,0.75,1,0.0666666666667,3,0.2
976,13,6,0.461538461538,1.0,0,0.0,6,0.461538461538
977,9,5,0.555555555556,0.6,2,0.222222222222,3,0.333333333333
978,12,4,0.333333333333,0.5,2,0.166666666667,2,0.166666666667
979,14,6,0.428571428571,0.833333333333,1,0.0714285714286,5,0.357142857143
980,12,7,0.583333333333,0.714285714286,2,0.166666666667,5,0.416666666667
981,11,6,0.545454545455,0.666666666667,2,0.181818181818,4,0.363636363636
982,10,6,0.6,0.666666666667,2,0.2,4,0.4
983,23,7,0.304347826087,0.714285714286,2,0.0869565217391,5,0.217391304348
984,14,6,0.428571428571,0.666666666667,2,0.142857142857,4,0.285714285714
985,8,5,0.625,1.0,0,0.0,5,0.625
986,21,11,0.52380952381,0.636363636364,4,0.190476190476,7,0.333333333333
987,22,7,0.318181818182,0.857142857143,1,0.0454545454545,6,0.272727272727
988,10,5,0.5,0.6,2,0.2,3,0.3
989,10,7,0.7,0.571428571429,3,0.3,4,0.4
990,18,10,0.555555555556,0.8,2,0.111111111111,8,0.444444444444
991,13,8,0.615384615385,0.625,3,0.230769230769,5,0.384615384615
992,12,5,0.416666666667,0.8,1,0.0833333333333,4,0.333333333333
993,16,8,0.5,0.75,2,0.125,6,0.375
994,14,10,0.714285714286,0.8,2,0.142857142857,8,0.571428571429
995,11,4,0.363636363636,0.75,1,0.0909090909091,3,0.272727272727
996,18,13,0.722222222222,0.692307692308,4,0.222222222222,9,0.5
997,11,5,0.454545454545,0.8,1,0.0909090909091,4,0.363636363636
998,19,9,0.473684210526,0.888888888889,1,0.0526315789474,8,0.421052631579
999,11,10,0.909090909091,0.9,1,0.0909090909091,9,0.818181818182
1000,19,7,0.368421052632,0.571428571429,3,0.157894736842,4,0.210526315789
1001,21,12,0.571428571429,0.666666666667,4,0.190476190476,8,0.380952380952
1002,11,7,0.636363636364,1.0,0,0.0,7,0.636363636364
1003,15,7,0.466666666667,0.714285714286,2,0.133333333333,5,0.333333333333
1004,10,5,0.5,0.8,1,0.1,4,0.4
1005,12,10,0.833333333333,1.0,0,0.0,10,0.833333333333
1006,13,11,0.846153846154,0.818181818182,2,0.153846153846,9,0.692307692308
1007,16,11,0.6875,0.636363636364,4,0.25,7,0.4375
1008,11,4,0.363636363636,0.75,1,0.0909090909091,3,0.272727272727
1009,16,8,0.5,0.75,2,0.125,6,0.375
1010,18,11,0.611111111111,0.909090909091,1,0.0555555555556,10,0.555555555556
1011,17,10,0.588235294118,0.8,2,0.117647058824,8,0.470588235294
1012,14,7,0.5,0.428571428571,4,0.285714285714,3,0.214285714286
1013,17,9,0.529411764706,0.666666666667,3,0.176470588235,6,0.352941176471
1014,19,12,0.631578947368,0.666666666667,4,0.210526315789,8,0.421052631579
1015,17,9,0.529411764706,0.555555555556,4,0.235294117647,5,0.294117647059
1016,11,9,0.818181818182,0.888888888889,1,0.0909090909091,8,0.727272727273
1017,14,9,0.642857142857,1.0,0,0.0,9,0.642857142857
1018,9,6,0.666666666667,0.666666666667,2,0.222222222222,4,0.444444444444
1019,12,8,0.666666666667,0.875,1,0.0833333333333,7,0.583333333333
1020,18,7,0.388888888889,0.714285714286,2,0.111111111111,5,0.277777777778
1021,11,6,0.545454545455,0.833333333333,1,0.0909090909091,5,0.454545454545
1022,13,6,0.461538461538,1.0,0,0.0,6,0.461538461538
1023,12,6,0.5,0.666666666667,2,0.166666666667,4,0.333333333333
1024,13,10,0.769230769231,0.9,1,0.0769230769231,9,0.692307692308
1025,15,7,0.466666666667,0.857142857143,1,0.0666666666667,6,0.4
1026,15,10,0.666666666667,0.7,3,0.2,7,0.466666666667
1027,17,10,0.588235294118,0.5,5,0.294117647059,5,0.294117647059
1028,13,7,0.538461538462,0.714285714286,2,0.153846153846,5,0.384615384615
1029,13,9,0.692307692308,0.777777777778,2,0.153846153846,7,0.538461538462
1030,17,14,0.823529411765,0.571428571429,6,0.352941176471,8,0.470588235294
1031,14,6,0.428571428571,0.5,3,0.214285714286,3,0.214285714286
1032,11,7,0.636363636364,0.857142857143,1,0.0909090909091,6,0.545454545455
1033,14,8,0.571428571429,0.75,2,0.142857142857,6,0.428571428571
1034,15,10,0.666666666667,1.0,0,0.0,10,0.666666666667
1035,13,7,0.538461538462,0.857142857143,1,0.0769230769231,6,0.461538461538
1036,12,8,0.666666666667,0.625,3,0.25,5,0.416666666667
1037,11,6,0.545454545455,0.666666666667,2,0.181818181818,4,0.363636363636
1038,19,10,0.526315789474,0.4,6,0.315789473684,4,0.210526315789
1039,15,6,0.4,0.5,3,0.2,3,0.2
1040,13,7,0.538461538462,0.857142857143,1,0.0769230769231,6,0.461538461538
1041,13,7,0.538461538462,0.714285714286,2,0.153846153846,5,0.384615384615
1042,14,6,0.428571428571,1.0,0,0.0,6,0.428571428571
1043,7,4,0.571428571429,0.75,1,0.142857142857,3,0.428571428571
1044,11,5,0.454545454545,0.8,1,0.0909090909091,4,0.363636363636
1045,13,10,0.769230769231,0.8,2,0.153846153846,8,0.615384615385
1046,14,6,0.428571428571,0.666666666667,2,0.142857142857,4,0.285714285714
1047,9,6,0.666666666667,0.5,3,0.333333333333,3,0.333333333333
1048,14,8,0.571428571429,0.75,2,0.142857142857,6,0.428571428571
1049,16,7,0.4375,0.714285714286,2,0.125,5,0.3125
1050,24,14,0.583333333333,0.714285714286,4,0.166666666667,10,0.416666666667
1051,16,10,0.625,0.6,4,0.25,6,0.375
1052,16,9,0.5625,1.0,0,0.0,9,0.5625
1053,12,7,0.583333333333,0.857142857143,1,0.0833333333333,6,0.5
1054,6,4,0.666666666667,0.75,1,0.166666666667,3,0.5
1055,8,3,0.375,1.0,0,0.0,3,0.375
1056,16,10,0.625,0.9,1,0.0625,9,0.5625
1057,18,8,0.444444444444,0.75,2,0.111111111111,6,0.333333333333
1058,7,1,0.142857142857,1.0,0,0.0,1,0.142857142857
1059,10,4,0.4,0.75,1,0.1,3,0.3
1060,17,13,0.764705882353,0.615384615385,5,0.294117647059,8,0.470588235294
1061,11,6,0.545454545455,0.833333333333,1,0.0909090909091,5,0.454545454545
1062,10,4,0.4,0.5,2,0.2,2,0.2
1063,6,3,0.5,1.0,0,0.0,3,0.5
1064,13,9,0.692307692308,0.666666666667,3,0.230769230769,6,0.461538461538
1065,9,5,0.555555555556,0.8,1,0.111111111111,4,0.444444444444
1066,14,10,0.714285714286,0.4,6,0.428571428571,4,0.285714285714
1067,12,5,0.416666666667,0.6,2,0.166666666667,3,0.25
1068,12,4,0.333333333333,1.0,0,0.0,4,0.333333333333
1069,10,5,0.5,1.0,0,0.0,5,0.5
1070,12,7,0.583333333333,0.714285714286,2,0.166666666667,5,0.416666666667
1071,10,6,0.6,0.666666666667,2,0.2,4,0.4
1072,6,5,0.833333333333,0.4,3,0.5,2,0.333333333333
1073,9,8,0.888888888889,0.75,2,0.222222222222,6,0.666666666667
1074,15,11,0.733333333333,0.818181818182,2,0.133333333333,9,0.6
1075,9,5,0.555555555556,1.0,0,0.0,5,0.555555555556
1076,16,9,0.5625,0.666666666667,3,0.1875,6,0.375
1077,8,7,0.875,0.714285714286,2,0.25,5,0.625
1078,13,7,0.538461538462,0.714285714286,2,0.153846153846,5,0.384615384615
1079,9,5,0.555555555556,0.8,1,0.111111111111,4,0.444444444444
1080,10,5,0.5,0.4,3,0.3,2,0.2
1081,9,6,0.666666666667,0.666666666667,2,0.222222222222,4,0.444444444444
1082,8,6,0.75,0.833333333333,1,0.125,5,0.625
1083,8,5,0.625,0.4,3,0.375,2,0.25
1084,9,4,0.444444444444,0.75,1,0.111111111111,3,0.333333333333
1085,12,7,0.583333333333,0.714285714286,2,0.166666666667,5,0.416666666667
1086,9,6,0.666666666667,0.666666666667,2,0.222222222222,4,0.444444444444
1087,19,9,0.473684210526,0.777777777778,2,0.105263157895,7,0.368421052632
1088,8,7,0.875,0.714285714286,2,0.25,5,0.625
1089,9,5,0.555555555556,0.8,1,0.111111111111,4,0.444444444444
1090,11,5,0.454545454545,0.8,1,0.0909090909091,4,0.363636363636
1091,10,5,0.5,0.8,1,0.1,4,0.4
1092,11,5,0.454545454545,0.6,2,0.181818181818,3,0.272727272727
1093,8,4,0.5,0.5,2,0.25,2,0.25
1094,5,2,0.4,0.0,2,0.4,0,0.0
1095,11,5,0.454545454545,0.6,2,0.181818181818,3,0.272727272727
1096,8,3,0.375,0.666666666667,1,0.125,2,0.25
1097,10,5,0.5,0.8,1,0.1,4,0.4
1098,10,8,0.8,0.75,2,0.2,6,0.6
1099,10,7,0.7,0.857142857143,1,0.1,6,0.6
1100,10,6,0.6,1.0,0,0.0,6,0.6
1101,14,5,0.357142857143,0.4,3,0.214285714286,2,0.142857142857
1102,12,10,0.833333333333,0.9,1,0.0833333333333,9,0.75
1103,11,6,0.545454545455,0.833333333333,1,0.0909090909091,5,0.454545454545
1104,5,2,0.4,1.0,0,0.0,2,0.4
1105,8,1,0.125,1.0,0,0.0,1,0.125
1106,12,9,0.75,0.777777777778,2,0.166666666667,7,0.583333333333
1107,13,9,0.692307692308,0.777777777778,2,0.153846153846,7,0.538461538462
1108,14,7,0.5,0.714285714286,2,0.142857142857,5,0.357142857143
1109,4,2,0.5,1.0,0,0.0,2,0.5
1110,9,5,0.555555555556,0.8,1,0.111111111111,4,0.444444444444
1111,8,3,0.375,0.666666666667,1,0.125,2,0.25
1112,11,6,0.545454545455,0.666666666667,2,0.181818181818,4,0.363636363636
1113,8,5,0.625,0.6,2,0.25,3,0.375
1114,12,9,0.75,0.333333333333,6,0.5,3,0.25
1115,12,6,0.5,0.5,3,0.25,3,0.25
1116,7,3,0.428571428571,1.0,0,0.0,3,0.428571428571
1117,12,8,0.666666666667,0.75,2,0.166666666667,6,0.5
1118,18,10,0.555555555556,0.9,1,0.0555555555556,9,0.5
1119,5,3,0.6,0.666666666667,1,0.2,2,0.4
1120,14,11,0.785714285714,0.818181818182,2,0.142857142857,9,0.642857142857
1121,7,4,0.571428571429,0.5,2,0.285714285714,2,0.285714285714
1122,10,6,0.6,0.833333333333,1,0.1,5,0.5
1123,9,3,0.333333333333,0.666666666667,1,0.111111111111,2,0.222222222222
1124,10,5,0.5,0.6,2,0.2,3,0.3
1125,14,11,0.785714285714,0.818181818182,2,0.142857142857,9,0.642857142857
1126,6,4,0.666666666667,0.5,2,0.333333333333,2,0.333333333333
1127,9,4,0.444444444444,1.0,0,0.0,4,0.444444444444
1128,7,2,0.285714285714,1.0,0,0.0,2,0.285714285714
1129,7,5,0.714285714286,0.4,3,0.428571428571,2,0.285714285714
1130,7,3,0.428571428571,1.0,0,0.0,3,0.428571428571
1131,9,6,0.666666666667,0.833333333333,1,0.111111111111,5,0.555555555556
1132,9,4,0.444444444444,1.0,0,0.0,4,0.444444444444
1133,12,8,0.666666666667,0.875,1,0.0833333333333,7,0.583333333333
1134,6,5,0.833333333333,0.8,1,0.166666666667,4,0.666666666667
1135,11,7,0.636363636364,0.714285714286,2,0.181818181818,5,0.454545454545
1136,9,3,0.333333333333,1.0,0,0.0,3,0.333333333333
1137,10,7,0.7,0.571428571429,3,0.3,4,0.4
1138,12,7,0.583333333333,0.571428571429,3,0.25,4,0.333333333333
1139,7,4,0.571428571429,0.75,1,0.142857142857,3,0.428571428571
1140,7,5,0.714285714286,0.2,4,0.571428571429,1,0.142857142857
1141,6,2,0.333333333333,1.0,0,0.0,2,0.333333333333
1142,11,6,0.545454545455,0.666666666667,2,0.181818181818,4,0.363636363636
1143,6,3,0.5,1.0,0,0.0,3,0.5
1144,9,4,0.444444444444,0.75,1,0.111111111111,3,0.333333333333
1145,8,4,0.5,1.0,0,0.0,4,0.5
1146,9,7,0.777777777778,0.571428571429,3,0.333333333333,4,0.444444444444
1147,5,3,0.6,0.666666666667,1,0.2,2,0.4
1148,13,7,0.538461538462,0.714285714286,2,0.153846153846,5,0.384615384615
1149,11,5,0.454545454545,0.8,1,0.0909090909091,4,0.363636363636
1150,11,6,0.545454545455,0.833333333333,1,0.0909090909091,5,0.454545454545
1151,6,2,0.333333333333,1.0,0,0.0,2,0.333333333333
1152,4,2,0.5,1.0,0,0.0,2,0.5
1153,8,3,0.375,1.0,0,0.0,3,0.375
1154,8,5,0.625,0.8,1,0.125,4,0.5
1155,10,4,0.4,1.0,0,0.0,4,0.4
1156,9,6,0.666666666667,0.666666666667,2,0.222222222222,4,0.444444444444
1157,11,6,0.545454545455,1.0,0,0.0,6,0.545454545455
1158,11,3,0.272727272727,1.0,0,0.0,3,0.272727272727
1159,8,2,0.25,1.0,0,0.0,2,0.25
1160,7,3,0.428571428571,1.0,0,0.0,3,0.428571428571
1161,8,5,0.625,0.8,1,0.125,4,0.5
1162,5,2,0.4,1.0,0,0.0,2,0.4
1163,5,3,0.6,1.0,0,0.0,3,0.6
1164,8,3,0.375,1.0,0,0.0,3,0.375
1165,14,9,0.642857142857,0.888888888889,1,0.0714285714286,8,0.571428571429
1166,3,1,0.333333333333,1.0,0,0.0,1,0.333333333333
1167,6,3,0.5,0.666666666667,1,0.166666666667,2,0.333333333333
1168,9,5,0.555555555556,0.6,2,0.222222222222,3,0.333333333333
1169,11,8,0.727272727273,0.75,2,0.181818181818,6,0.545454545455
1170,5,3,0.6,0.666666666667,1,0.2,2,0.4
1171,12,8,0.666666666667,0.75,2,0.166666666667,6,0.5
1172,8,4,0.5,0.75,1,0.125,3,0.375
1173,9,6,0.666666666667,1.0,0,0.0,6,0.666666666667
1174,5,4,0.8,0.75,1,0.2,3,0.6
1175,7,6,0.857142857143,0.833333333333,1,0.142857142857,5,0.714285714286
1176,9,3,0.333333333333,0.333333333333,2,0.222222222222,1,0.111111111111
1177,8,4,0.5,0.75,1,0.125,3,0.375
1178,9,7,0.777777777778,0.571428571429,3,0.333333333333,4,0.444444444444
1179,11,5,0.454545454545,0.4,3,0.272727272727,2,0.181818181818
1180,6,5,0.833333333333,0.8,1,0.166666666667,4,0.666666666667
1181,7,4,0.571428571429,1.0,0,0.0,4,0.571428571429
1182,10,8,0.8,0.625,3,0.3,5,0.5
1183,9,6,0.666666666667,0.833333333333,1,0.111111111111,5,0.555555555556
1184,9,3,0.333333333333,0.333333333333,2,0.222222222222,1,0.111111111111
1185,6,3,0.5,0.333333333333,2,0.333333333333,1,0.166666666667
1186,9,4,0.444444444444,0.5,2,0.222222222222,2,0.222222222222
1187,5,4,0.8,1.0,0,0.0,4,0.8
1188,5,3,0.6,1.0,0,0.0,3,0.6
1189,12,10,0.833333333333,0.8,2,0.166666666667,8,0.666666666667
1190,6,4,0.666666666667,0.75,1,0.166666666667,3,0.5
1191,8,6,0.75,0.833333333333,1,0.125,5,0.625
1192,5,5,1.0,0.8,1,0.2,4,0.8
1193,8,2,0.25,0.5,1,0.125,1,0.125
1194,4,3,0.75,1.0,0,0.0,3,0.75
1195,11,4,0.363636363636,1.0,0,0.0,4,0.363636363636
1196,7,1,0.142857142857,1.0,0,0.0,1,0.142857142857
1197,3,0,0.0,nan,0,0.0,0,0.0
1198,5,2,0.4,0.0,2,0.4,0,0.0
1199,7,3,0.428571428571,0.333333333333,2,0.285714285714,1,0.142857142857
1200,9,4,0.444444444444,0.75,1,0.111111111111,3,0.333333333333
1201,8,5,0.625,0.6,2,0.25,3,0.375
1202,10,7,0.7,1.0,0,0.0,7,0.7
1203,8,4,0.5,1.0,0,0.0,4,0.5
1204,9,5,0.555555555556,0.8,1,0.111111111111,4,0.444444444444
1205,6,3,0.5,0.666666666667,1,0.166666666667,2,0.333333333333
1206,14,7,0.5,0.714285714286,2,0.142857142857,5,0.357142857143
1207,8,2,0.25,0.5,1,0.125,1,0.125
1208,9,8,0.888888888889,0.75,2,0.222222222222,6,0.666666666667
1209,5,4,0.8,0.5,2,0.4,2,0.4
1210,7,5,0.714285714286,0.4,3,0.428571428571,2,0.285714285714
1211,10,4,0.4,0.75,1,0.1,3,0.3
1212,11,6,0.545454545455,0.833333333333,1,0.0909090909091,5,0.454545454545
1213,8,4,0.5,0.5,2,0.25,2,0.25
1214,15,11,0.733333333333,0.636363636364,4,0.266666666667,7,0.466666666667
1215,8,3,0.375,1.0,0,0.0,3,0.375
1216,10,6,0.6,0.666666666667,2,0.2,4,0.4
1217,8,6,0.75,1.0,0,0.0,6,0.75
1218,10,5,0.5,0.8,1,0.1,4,0.4
1219,11,4,0.363636363636,1.0,0,0.0,4,0.363636363636
1220,4,2,0.5,0.0,2,0.5,0,0.0
1221,3,2,0.666666666667,0.0,2,0.666666666667,0,0.0
1222,7,4,0.571428571429,0.75,1,0.142857142857,3,0.428571428571
1223,6,3,0.5,0.666666666667,1,0.166666666667,2,0.333333333333
1224,10,5,0.5,0.6,2,0.2,3,0.3
1225,9,3,0.333333333333,0.666666666667,1,0.111111111111,2,0.222222222222
1226,5,2,0.4,1.0,0,0.0,2,0.4
1227,6,5,0.833333333333,0.6,2,0.333333333333,3,0.5
1228,4,3,0.75,0.666666666667,1,0.25,2,0.5
1229,6,4,0.666666666667,1.0,0,0.0,4,0.666666666667
1230,8,5,0.625,1.0,0,0.0,5,0.625
1231,8,4,0.5,0.75,1,0.125,3,0.375
1232,7,6,0.857142857143,0.833333333333,1,0.142857142857,5,0.714285714286
1233,6,2,0.333333333333,1.0,0,0.0,2,0.333333333333
1234,7,2,0.285714285714,1.0,0,0.0,2,0.285714285714
1235,6,4,0.666666666667,0.75,1,0.166666666667,3,0.5
1236,2,2,1.0,1.0,0,0.0,2,1.0
1237,4,1,0.25,1.0,0,0.0,1,0.25
1238,8,4,0.5,0.5,2,0.25,2,0.25
1239,6,4,0.666666666667,0.5,2,0.333333333333,2,0.333333333333
1240,6,3,0.5,0.666666666667,1,0.166666666667,2,0.333333333333
1241,1,0,0.0,nan,0,0.0,0,0.0
1242,6,3,0.5,1.0,0,0.0,3,0.5
1243,3,2,0.666666666667,1.0,0,0.0,2,0.666666666667
1244,4,4,1.0,1.0,0,0.0,4,1.0
1245,4,3,0.75,1.0,0,0.0,3,0.75
1246,8,3,0.375,0.666666666667,1,0.125,2,0.25
1247,4,3,0.75,0.666666666667,1,0.25,2,0.5
1248,10,6,0.6,0.666666666667,2,0.2,4,0.4
1249,11,5,0.454545454545,0.2,4,0.363636363636,1,0.0909090909091
1250,5,4,0.8,0.5,2,0.4,2,0.4
1251,2,1,0.5,1.0,0,0.0,1,0.5
1252,5,4,0.8,1.0,0,0.0,4,0.8
1253,6,4,0.666666666667,0.25,3,0.5,1,0.166666666667
1254,7,4,0.571428571429,0.75,1,0.142857142857,3,0.428571428571
1255,7,5,0.714285714286,0.6,2,0.285714285714,3,0.428571428571
1256,5,1,0.2,0.0,1,0.2,0,0.0
1257,8,7,0.875,0.571428571429,3,0.375,4,0.5
1258,3,1,0.333333333333,1.0,0,0.0,1,0.333333333333
1259,8,6,0.75,0.833333333333,1,0.125,5,0.625
1260,5,3,0.6,1.0,0,0.0,3,0.6
1261,4,2,0.5,0.5,1,0.25,1,0.25
1262,8,5,0.625,0.6,2,0.25,3,0.375
1263,6,2,0.333333333333,1.0,0,0.0,2,0.333333333333
1264,4,2,0.5,0.5,1,0.25,1,0.25
1265,9,5,0.555555555556,1.0,0,0.0,5,0.555555555556
1266,8,4,0.5,1.0,0,0.0,4,0.5
1267,5,2,0.4,1.0,0,0.0,2,0.4
1268,6,4,0.666666666667,0.75,1,0.166666666667,3,0.5
1269,4,2,0.5,1.0,0,0.0,2,0.5
1270,5,1,0.2,0.0,1,0.2,0,0.0
1271,10,6,0.6,0.833333333333,1,0.1,5,0.5
1272,2,2,1.0,1.0,0,0.0,2,1.0
1273,6,3,0.5,1.0,0,0.0,3,0.5
1274,2,0,0.0,nan,0,0.0,0,0.0
1275,8,5,0.625,0.4,3,0.375,2,0.25
1276,4,1,0.25,1.0,0,0.0,1,0.25
1277,7,5,0.714285714286,0.8,1,0.142857142857,4,0.571428571429
1278,7,7,1.0,0.857142857143,1,0.142857142857,6,0.857142857143
1279,5,3,0.6,0.666666666667,1,0.2,2,0.4
1280,6,3,0.5,1.0,0,0.0,3,0.5
1281,7,4,0.571428571429,0.75,1,0.142857142857,3,0.428571428571
1282,5,3,0.6,0.333333333333,2,0.4,1,0.2
1283,6,3,0.5,0.0,3,0.5,0,0.0
1284,3,1,0.333333333333,1.0,0,0.0,1,0.333333333333
1285,6,3,0.5,1.0,0,0.0,3,0.5
1286,5,3,0.6,0.666666666667,1,0.2,2,0.4
1287,3,0,0.0,nan,0,0.0,0,0.0
1288,6,2,0.333333333333,1.0,0,0.0,2,0.333333333333
1289,3,2,0.666666666667,1.0,0,0.0,2,0.666666666667
1290,5,3,0.6,1.0,0,0.0,3,0.6
1291,4,3,0.75,0.666666666667,1,0.25,2,0.5
1292,7,3,0.428571428571,1.0,0,0.0,3,0.428571428571
1293,7,6,0.857142857143,0.5,3,0.428571428571,3,0.428571428571
1294,4,0,0.0,nan,0,0.0,0,0.0
1295,4,2,0.5,0.5,1,0.25,1,0.25
1296,3,2,0.666666666667,0.5,1,0.333333333333,1,0.333333333333
1297,5,4,0.8,0.5,2,0.4,2,0.4
1298,4,2,0.5,0.5,1,0.25,1,0.25
1299,4,3,0.75,1.0,0,0.0,3,0.75
1300,15,12,0.8,0.75,3,0.2,9,0.6
1301,3,0,0.0,nan,0,0.0,0,0.0
1302,8,6,0.75,0.5,3,0.375,3,0.375
1303,5,3,0.6,0.333333333333,2,0.4,1,0.2
1304,8,4,0.5,0.75,1,0.125,3,0.375
1305,8,5,0.625,0.6,2,0.25,3,0.375
1306,3,0,0.0,nan,0,0.0,0,0.0
1307,3,2,0.666666666667,1.0,0,0.0,2,0.666666666667
1308,7,2,0.285714285714,1.0,0,0.0,2,0.285714285714
1309,5,3,0.6,0.333333333333,2,0.4,1,0.2
1310,7,4,0.571428571429,1.0,0,0.0,4,0.571428571429
1311,3,2,0.666666666667,1.0,0,0.0,2,0.666666666667
1312,4,2,0.5,1.0,0,0.0,2,0.5
1313,3,0,0.0,nan,0,0.0,0,0.0
1314,3,3,1.0,1.0,0,0.0,3,1.0
1315,2,2,1.0,0.5,1,0.5,1,0.5
1316,6,4,0.666666666667,0.5,2,0.333333333333,2,0.333333333333
1317,5,4,0.8,1.0,0,0.0,4,0.8
1318,9,5,0.555555555556,0.8,1,0.111111111111,4,0.444444444444
1319,5,4,0.8,1.0,0,0.0,4,0.8
1320,7,6,0.857142857143,0.333333333333,4,0.571428571429,2,0.285714285714
1321,7,4,0.571428571429,0.75,1,0.142857142857,3,0.428571428571
1322,6,5,0.833333333333,0.6,2,0.333333333333,3,0.5
1323,3,0,0.0,nan,0,0.0,0,0.0
1324,7,6,0.857142857143,0.666666666667,2,0.285714285714,4,0.571428571429
1325,5,2,0.4,1.0,0,0.0,2,0.4
1326,7,5,0.714285714286,0.8,1,0.142857142857,4,0.571428571429
1327,6,4,0.666666666667,1.0,0,0.0,4,0.666666666667
1328,2,1,0.5,1.0,0,0.0,1,0.5
1329,2,1,0.5,1.0,0,0.0,1,0.5
1330,2,1,0.5,1.0,0,0.0,1,0.5
1331,6,4,0.666666666667,0.5,2,0.333333333333,2,0.333333333333
1332,3,1,0.333333333333,1.0,0,0.0,1,0.333333333333
1333,8,6,0.75,0.833333333333,1,0.125,5,0.625
1334,6,4,0.666666666667,0.75,1,0.166666666667,3,0.5
1335,1,0,0.0,nan,0,0.0,0,0.0
1336,7,3,0.428571428571,0.666666666667,1,0.142857142857,2,0.285714285714
1337,5,4,0.8,0.5,2,0.4,2,0.4
1338,3,1,0.333333333333,0.0,1,0.333333333333,0,0.0
1339,5,3,0.6,1.0,0,0.0,3,0.6
1340,4,3,0.75,0.333333333333,2,0.5,1,0.25
1341,4,2,0.5,1.0,0,0.0,2,0.5
1342,2,1,0.5,0.0,1,0.5,0,0.0
1343,5,3,0.6,0.333333333333,2,0.4,1,0.2
1344,2,2,1.0,1.0,0,0.0,2,1.0
1345,4,4,1.0,0.75,1,0.25,3,0.75
1346,5,3,0.6,0.666666666667,1,0.2,2,0.4
1347,4,2,0.5,1.0,0,0.0,2,0.5
1348,2,1,0.5,0.0,1,0.5,0,0.0
1349,6,5,0.833333333333,0.6,2,0.333333333333,3,0.5
1350,5,3,0.6,1.0,0,0.0,3,0.6
1351,8,8,1.0,0.875,1,0.125,7,0.875
1352,5,5,1.0,0.8,1,0.2,4,0.8
1353,3,2,0.666666666667,1.0,0,0.0,2,0.666666666667
1354,9,6,0.666666666667,0.5,3,0.333333333333,3,0.333333333333
1355,8,6,0.75,0.833333333333,1,0.125,5,0.625
1356,7,5,0.714285714286,0.6,2,0.285714285714,3,0.428571428571
1357,2,0,0.0,nan,0,0.0,0,0.0
1358,4,3,0.75,1.0,0,0.0,3,0.75
1359,4,2,0.5,1.0,0,0.0,2,0.5
1360,3,2,0.666666666667,1.0,0,0.0,2,0.666666666667
1361,2,0,0.0,nan,0,0.0,0,0.0
1362,8,4,0.5,1.0,0,0.0,4,0.5
1363,3,2,0.666666666667,0.0,2,0.666666666667,0,0.0
1364,8,4,0.5,1.0,0,0.0,4,0.5
1365,5,2,0.4,0.0,2,0.4,0,0.0
1366,8,3,0.375,0.666666666667,1,0.125,2,0.25
1367,5,3,0.6,1.0,0,0.0,3,0.6
1368,7,6,0.857142857143,0.666666666667,2,0.285714285714,4,0.571428571429
1369,5,3,0.6,1.0,0,0.0,3,0.6
1370,4,3,0.75,1.0,0,0.0,3,0.75
1371,5,3,0.6,0.666666666667,1,0.2,2,0.4
1372,6,2,0.333333333333,0.5,1,0.166666666667,1,0.166666666667
1373,6,3,0.5,1.0,0,0.0,3,0.5
1374,6,2,0.333333333333,0.5,1,0.166666666667,1,0.166666666667
1375,3,1,0.333333333333,1.0,0,0.0,1,0.333333333333
1376,5,4,0.8,1.0,0,0.0,4,0.8
1377,3,3,1.0,1.0,0,0.0,3,1.0
1378,7,4,0.571428571429,0.75,1,0.142857142857,3,0.428571428571
1379,2,2,1.0,1.0,0,0.0,2,1.0
1380,4,2,0.5,1.0,0,0.0,2,0.5
1381,4,3,0.75,0.0,3,0.75,0,0.0
1382,3,1,0.333333333333,0.0,1,0.333333333333,0,0.0
1383,4,2,0.5,1.0,0,0.0,2,0.5
1384,2,2,1.0,0.5,1,0.5,1,0.5
1385,5,3,0.6,0.666666666667,1,0.2,2,0.4
1386,5,3,0.6,0.666666666667,1,0.2,2,0.4
1387,3,2,0.666666666667,1.0,0,0.0,2,0.666666666667
1388,2,2,1.0,1.0,0,0.0,2,1.0
1389,7,4,0.571428571429,0.75,1,0.142857142857,3,0.428571428571
1390,2,1,0.5,0.0,1,0.5,0,0.0
1391,6,5,0.833333333333,0.4,3,0.5,2,0.333333333333
1392,10,3,0.3,1.0,0,0.0,3,0.3
1393,6,2,0.333333333333,0.5,1,0.166666666667,1,0.166666666667
1394,3,0,0.0,nan,0,0.0,0,0.0
1395,7,4,0.571428571429,0.75,1,0.142857142857,3,0.428571428571
1396,6,3,0.5,1.0,0,0.0,3,0.5
1397,2,2,1.0,0.5,1,0.5,1,0.5
1398,1,1,1.0,0.0,1,1.0,0,0.0
1399,5,2,0.4,0.5,1,0.2,1,0.2
1400,5,3,0.6,0.666666666667,1,0.2,2,0.4
1401,4,3,0.75,0.333333333333,2,0.5,1,0.25
1402,6,1,0.166666666667,1.0,0,0.0,1,0.166666666667
1403,3,2,0.666666666667,1.0,0,0.0,2,0.666666666667
1404,4,2,0.5,1.0,0,0.0,2,0.5
1405,5,4,0.8,0.75,1,0.2,3,0.6
1406,2,1,0.5,0.0,1,0.5,0,0.0
1407,1,0,0.0,nan,0,0.0,0,0.0
1408,2,1,0.5,0.0,1,0.5,0,0.0
1409,3,2,0.666666666667,0.0,2,0.666666666667,0,0.0
1410,1,1,1.0,0.0,1,1.0,0,0.0
1411,3,1,0.333333333333,0.0,1,0.333333333333,0,0.0
1412,6,4,0.666666666667,1.0,0,0.0,4,0.666666666667
1413,2,2,1.0,0.5,1,0.5,1,0.5
1414,3,2,0.666666666667,1.0,0,0.0,2,0.666666666667
1415,4,3,0.75,1.0,0,0.0,3,0.75
1416,4,3,0.75,0.333333333333,2,0.5,1,0.25
1417,5,3,0.6,1.0,0,0.0,3,0.6
1418,3,2,0.666666666667,0.0,2,0.666666666667,0,0.0
1419,3,3,1.0,0.666666666667,1,0.333333333333,2,0.666666666667
1420,6,2,0.333333333333,0.5,1,0.166666666667,1,0.166666666667
1421,2,2,1.0,0.5,1,0.5,1,0.5
1422,2,0,0.0,nan,0,0.0,0,0.0
1423,8,3,0.375,0.333333333333,2,0.25,1,0.125
1424,3,0,0.0,nan,0,0.0,0,0.0
1425,4,2,0.5,0.5,1,0.25,1,0.25
1426,5,2,0.4,0.5,1,0.2,1,0.2
1427,4,2,0.5,1.0,0,0.0,2,0.5
1428,1,0,0.0,nan,0,0.0,0,0.0
1429,2,1,0.5,1.0,0,0.0,1,0.5
1430,3,1,0.333333333333,1.0,0,0.0,1,0.333333333333
1431,1,0,0.0,nan,0,0.0,0,0.0
1432,9,6,0.666666666667,0.666666666667,2,0.222222222222,4,0.444444444444
1433,2,2,1.0,0.0,2,1.0,0,0.0
1434,8,5,0.625,0.6,2,0.25,3,0.375
1435,1,1,1.0,0.0,1,1.0,0,0.0
1436,5,3,0.6,1.0,0,0.0,3,0.6
1437,3,0,0.0,nan,0,0.0,0,0.0
1438,4,4,1.0,1.0,0,0.0,4,1.0
1439,6,4,0.666666666667,0.5,2,0.333333333333,2,0.333333333333
1440,4,4,1.0,0.25,3,0.75,1,0.25
1441,6,3,0.5,0.666666666667,1,0.166666666667,2,0.333333333333
1442,2,1,0.5,1.0,0,0.0,1,0.5
1443,4,3,0.75,0.666666666667,1,0.25,2,0.5
1444,4,2,0.5,0.5,1,0.25,1,0.25
1445,2,2,1.0,0.5,1,0.5,1,0.5
1446,5,3,0.6,0.666666666667,1,0.2,2,0.4
1447,1,1,1.0,0.0,1,1.0,0,0.0
1448,5,2,0.4,0.5,1,0.2,1,0.2
1449,2,2,1.0,0.5,1,0.5,1,0.5
1450,4,3,0.75,1.0,0,0.0,3,0.75
1451,2,0,0.0,nan,0,0.0,0,0.0
1452,4,2,0.5,1.0,0,0.0,2,0.5
1453,2,0,0.0,nan,0,0.0,0,0.0
1454,6,3,0.5,0.666666666667,1,0.166666666667,2,0.333333333333
1455,5,4,0.8,0.5,2,0.4,2,0.4
1456,5,2,0.4,1.0,0,0.0,2,0.4
1457,1,1,1.0,0.0,1,1.0,0,0.0
1458,6,2,0.333333333333,1.0,0,0.0,2,0.333333333333
1459,5,3,0.6,1.0,0,0.0,3,0.6
1460,4,2,0.5,1.0,0,0.0,2,0.5
1461,2,1,0.5,0.0,1,0.5,0,0.0
1462,1,1,1.0,1.0,0,0.0,1,1.0
1463,6,3,0.5,0.666666666667,1,0.166666666667,2,0.333333333333
1464,2,2,1.0,1.0,0,0.0,2,1.0
1465,2,1,0.5,1.0,0,0.0,1,0.5
1466,5,3,0.6,0.666666666667,1,0.2,2,0.4
1467,6,4,0.666666666667,0.75,1,0.166666666667,3,0.5
1468,1,1,1.0,1.0,0,0.0,1,1.0
1469,4,3,0.75,1.0,0,0.0,3,0.75
1470,2,2,1.0,0.5,1,0.5,1,0.5
1471,5,3,0.6,0.666666666667,1,0.2,2,0.4
1472,3,1,0.333333333333,1.0,0,0.0,1,0.333333333333
1473,2,2,1.0,1.0,0,0.0,2,1.0
1474,3,1,0.333333333333,1.0,0,0.0,1,0.333333333333
1475,3,1,0.333333333333,1.0,0,0.0,1,0.333333333333
1476,2,1,0.5,0.0,1,0.5,0,0.0
1477,2,2,1.0,0.5,1,0.5,1,0.5
1478,5,4,0.8,0.75,1,0.2,3,0.6
1480,5,2,0.4,1.0,0,0.0,2,0.4
1481,3,1,0.333333333333,1.0,0,0.0,1,0.333333333333
1482,8,1,0.125,0.0,1,0.125,0,0.0
1483,4,1,0.25,0.0,1,0.25,0,0.0
1484,3,2,0.666666666667,0.5,1,0.333333333333,1,0.333333333333
1485,2,0,0.0,nan,0,0.0,0,0.0
1486,1,1,1.0,1.0,0,0.0,1,1.0
1487,4,3,0.75,0.666666666667,1,0.25,2,0.5
1488,3,2,0.666666666667,0.5,1,0.333333333333,1,0.333333333333
1489,5,3,0.6,1.0,0,0.0,3,0.6
1490,2,1,0.5,1.0,0,0.0,1,0.5
1491,2,0,0.0,nan,0,0.0,0,0.0
1492,4,3,0.75,0.666666666667,1,0.25,2,0.5
1493,4,2,0.5,1.0,0,0.0,2,0.5
1494,3,3,1.0,0.666666666667,1,0.333333333333,2,0.666666666667
1495,5,2,0.4,1.0,0,0.0,2,0.4
1496,2,2,1.0,0.5,1,0.5,1,0.5
1497,4,3,0.75,1.0,0,0.0,3,0.75
1498,4,1,0.25,0.0,1,0.25,0,0.0
1499,3,1,0.333333333333,1.0,0,0.0,1,0.333333333333
1500,4,3,0.75,0.666666666667,1,0.25,2,0.5
1501,2,2,1.0,1.0,0,0.0,2,1.0
1502,2,2,1.0,1.0,0,0.0,2,1.0
1503,1,0,0.0,nan,0,0.0,0,0.0
1504,4,3,0.75,1.0,0,0.0,3,0.75
1505,3,2,0.666666666667,1.0,0,0.0,2,0.666666666667
1506,5,2,0.4,0.5,1,0.2,1,0.2
1508,7,3,0.428571428571,0.666666666667,1,0.142857142857,2,0.285714285714
1509,3,2,0.666666666667,0.5,1,0.333333333333,1,0.333333333333
1510,3,1,0.333333333333,1.0,0,0.0,1,0.333333333333
1511,5,3,0.6,1.0,0,0.0,3,0.6
1512,5,4,0.8,1.0,0,0.0,4,0.8
1513,5,4,0.8,1.0,0,0.0,4,0.8
1514,2,1,0.5,1.0,0,0.0,1,0.5
1515,2,1,0.5,0.0,1,0.5,0,0.0
1516,7,4,0.571428571429,1.0,0,0.0,4,0.571428571429
1517,3,2,0.666666666667,1.0,0,0.0,2,0.666666666667
1518,2,1,0.5,1.0,0,0.0,1,0.5
1519,4,2,0.5,1.0,0,0.0,2,0.5
1520,3,1,0.333333333333,1.0,0,0.0,1,0.333333333333
1521,4,4,1.0,0.75,1,0.25,3,0.75
1522,3,1,0.333333333333,1.0,0,0.0,1,0.333333333333
1523,3,1,0.333333333333,1.0,0,0.0,1,0.333333333333
1524,2,2,1.0,1.0,0,0.0,2,1.0
1525,8,1,0.125,1.0,0,0.0,1,0.125
1528,1,1,1.0,1.0,0,0.0,1,1.0
1529,1,1,1.0,0.0,1,1.0,0,0.0
1530,4,2,0.5,0.5,1,0.25,1,0.25
1532,1,1,1.0,0.0,1,1.0,0,0.0
1533,1,1,1.0,1.0,0,0.0,1,1.0
1534,4,2,0.5,1.0,0,0.0,2,0.5
1535,3,2,0.666666666667,0.5,1,0.333333333333,1,0.333333333333
1536,4,2,0.5,1.0,0,0.0,2,0.5
1537,2,1,0.5,0.0,1,0.5,0,0.0
1538,4,3,0.75,0.666666666667,1,0.25,2,0.5
1539,6,2,0.333333333333,1.0,0,0.0,2,0.333333333333
1540,2,0,0.0,nan,0,0.0,0,0.0
1542,3,3,1.0,1.0,0,0.0,3,1.0
1543,3,3,1.0,0.666666666667,1,0.333333333333,2,0.666666666667
1544,5,1,0.2,0.0,1,0.2,0,0.0
1545,3,3,1.0,1.0,0,0.0,3,1.0
1546,7,2,0.285714285714,1.0,0,0.0,2,0.285714285714
1547,1,1,1.0,1.0,0,0.0,1,1.0
1548,6,3,0.5,0.666666666667,1,0.166666666667,2,0.333333333333
1550,1,1,1.0,1.0,0,0.0,1,1.0
1551,4,3,0.75,1.0,0,0.0,3,0.75
1552,5,4,0.8,0.75,1,0.2,3,0.6
1553,3,1,0.333333333333,1.0,0,0.0,1,0.333333333333
1554,5,3,0.6,0.666666666667,1,0.2,2,0.4
1555,3,0,0.0,nan,0,0.0,0,0.0
1556,1,1,1.0,1.0,0,0.0,1,1.0
1557,4,1,0.25,1.0,0,0.0,1,0.25
1558,2,1,0.5,1.0,0,0.0,1,0.5
1559,3,2,0.666666666667,0.5,1,0.333333333333,1,0.333333333333
1560,3,2,0.666666666667,1.0,0,0.0,2,0.666666666667
1563,4,3,0.75,1.0,0,0.0,3,0.75
1565,3,0,0.0,nan,0,0.0,0,0.0
1566,3,2,0.666666666667,0.0,2,0.666666666667,0,0.0
1567,3,2,0.666666666667,0.5,1,0.333333333333,1,0.333333333333
1568,4,1,0.25,1.0,0,0.0,1,0.25
1569,3,1,0.333333333333,0.0,1,0.333333333333,0,0.0
1570,3,2,0.666666666667,1.0,0,0.0,2,0.666666666667
1571,1,1,1.0,1.0,0,0.0,1,1.0
1572,1,0,0.0,nan,0,0.0,0,0.0
1573,5,3,0.6,1.0,0,0.0,3,0.6
1574,3,1,0.333333333333,1.0,0,0.0,1,0.333333333333
1575,3,2,0.666666666667,0.5,1,0.333333333333,1,0.333333333333
1576,4,1,0.25,0.0,1,0.25,0,0.0
1577,2,2,1.0,1.0,0,0.0,2,1.0
1578,2,2,1.0,0.5,1,0.5,1,0.5
1579,2,0,0.0,nan,0,0.0,0,0.0
1580,3,3,1.0,0.666666666667,1,0.333333333333,2,0.666666666667
1581,1,1,1.0,0.0,1,1.0,0,0.0
1582,2,1,0.5,0.0,1,0.5,0,0.0
1583,2,1,0.5,1.0,0,0.0,1,0.5
1584,2,2,1.0,1.0,0,0.0,2,1.0
1585,2,0,0.0,nan,0,0.0,0,0.0
1586,1,1,1.0,1.0,0,0.0,1,1.0
1587,2,0,0.0,nan,0,0.0,0,0.0
1588,1,1,1.0,0.0,1,1.0,0,0.0
1589,1,1,1.0,1.0,0,0.0,1,1.0
1590,3,2,0.666666666667,1.0,0,0.0,2,0.666666666667
1591,1,0,0.0,nan,0,0.0,0,0.0
1592,4,2,0.5,1.0,0,0.0,2,0.5
1593,1,1,1.0,1.0,0,0.0,1,1.0
1594,4,2,0.5,1.0,0,0.0,2,0.5
1595,2,1,0.5,0.0,1,0.5,0,0.0
1596,1,1,1.0,0.0,1,1.0,0,0.0
1597,1,1,1.0,1.0,0,0.0,1,1.0
1598,2,2,1.0,0.0,2,1.0,0,0.0
1599,5,3,0.6,0.333333333333,2,0.4,1,0.2
1600,3,3,1.0,1.0,0,0.0,3,1.0
1601,2,1,0.5,1.0,0,0.0,1,0.5
1602,2,1,0.5,1.0,0,0.0,1,0.5
1603,2,0,0.0,nan,0,0.0,0,0.0
1604,2,0,0.0,nan,0,0.0,0,0.0
1605,3,2,0.666666666667,0.5,1,0.333333333333,1,0.333333333333
1606,5,2,0.4,0.0,2,0.4,0,0.0
1608,1,0,0.0,nan,0,0.0,0,0.0
1609,4,3,0.75,0.666666666667,1,0.25,2,0.5
1610,3,0,0.0,nan,0,0.0,0,0.0
1611,1,1,1.0,1.0,0,0.0,1,1.0
1612,4,2,0.5,1.0,0,0.0,2,0.5
1613,4,0,0.0,nan,0,0.0,0,0.0
1614,3,3,1.0,1.0,0,0.0,3,1.0
1615,3,1,0.333333333333,1.0,0,0.0,1,0.333333333333
1616,6,5,0.833333333333,0.8,1,0.166666666667,4,0.666666666667
1617,2,1,0.5,1.0,0,0.0,1,0.5
1618,3,1,0.333333333333,1.0,0,0.0,1,0.333333333333
1619,5,2,0.4,1.0,0,0.0,2,0.4
1620,1,1,1.0,0.0,1,1.0,0,0.0
1621,3,1,0.333333333333,0.0,1,0.333333333333,0,0.0
1622,3,2,0.666666666667,0.5,1,0.333333333333,1,0.333333333333
1623,2,2,1.0,0.5,1,0.5,1,0.5
1624,2,1,0.5,1.0,0,0.0,1,0.5
1625,3,1,0.333333333333,1.0,0,0.0,1,0.333333333333
1626,6,1,0.166666666667,1.0,0,0.0,1,0.166666666667
1627,3,3,1.0,0.666666666667,1,0.333333333333,2,0.666666666667
1628,2,1,0.5,1.0,0,0.0,1,0.5
1629,3,2,0.666666666667,1.0,0,0.0,2,0.666666666667
1630,3,2,0.666666666667,0.0,2,0.666666666667,0,0.0
1631,1,1,1.0,1.0,0,0.0,1,1.0
1632,1,0,0.0,nan,0,0.0,0,0.0
1633,4,2,0.5,0.5,1,0.25,1,0.25
1634,4,3,0.75,0.666666666667,1,0.25,2,0.5
1635,2,1,0.5,1.0,0,0.0,1,0.5
1636,3,3,1.0,1.0,0,0.0,3,1.0
1637,4,2,0.5,0.5,1,0.25,1,0.25
1638,3,0,0.0,nan,0,0.0,0,0.0
1639,1,1,1.0,1.0,0,0.0,1,1.0
1640,1,0,0.0,nan,0,0.0,0,0.0
1641,2,0,0.0,nan,0,0.0,0,0.0
1643,3,3,1.0,0.666666666667,1,0.333333333333,2,0.666666666667
1644,2,2,1.0,0.5,1,0.5,1,0.5
1645,3,1,0.333333333333,0.0,1,0.333333333333,0,0.0
1646,3,2,0.666666666667,0.5,1,0.333333333333,1,0.333333333333
1647,3,1,0.333333333333,1.0,0,0.0,1,0.333333333333
1648,2,2,1.0,0.0,2,1.0,0,0.0
1649,3,1,0.333333333333,0.0,1,0.333333333333,0,0.0
1650,3,2,0.666666666667,0.5,1,0.333333333333,1,0.333333333333
1651,2,1,0.5,1.0,0,0.0,1,0.5
1652,4,3,0.75,0.333333333333,2,0.5,1,0.25
1653,3,3,1.0,1.0,0,0.0,3,1.0
1654,7,3,0.428571428571,1.0,0,0.0,3,0.428571428571
1655,2,1,0.5,1.0,0,0.0,1,0.5
1656,1,1,1.0,1.0,0,0.0,1,1.0
1657,2,2,1.0,0.5,1,0.5,1,0.5
1658,1,0,0.0,nan,0,0.0,0,0.0
1659,3,3,1.0,0.666666666667,1,0.333333333333,2,0.666666666667
1660,3,0,0.0,nan,0,0.0,0,0.0
1661,2,1,0.5,1.0,0,0.0,1,0.5
1663,2,1,0.5,1.0,0,0.0,1,0.5
1664,1,0,0.0,nan,0,0.0,0,0.0
1666,1,1,1.0,1.0,0,0.0,1,1.0
1667,3,1,0.333333333333,1.0,0,0.0,1,0.333333333333
1668,3,1,0.333333333333,1.0,0,0.0,1,0.333333333333
1670,2,0,0.0,nan,0,0.0,0,0.0
1671,3,2,0.666666666667,1.0,0,0.0,2,0.666666666667
1672,6,4,0.666666666667,0.75,1,0.166666666667,3,0.5
1673,3,2,0.666666666667,0.5,1,0.333333333333,1,0.333333333333
1674,1,0,0.0,nan,0,0.0,0,0.0
1675,2,1,0.5,0.0,1,0.5,0,0.0
1676,1,0,0.0,nan,0,0.0,0,0.0
1677,1,0,0.0,nan,0,0.0,0,0.0
1678,3,1,0.333333333333,0.0,1,0.333333333333,0,0.0
1679,2,1,0.5,1.0,0,0.0,1,0.5
1681,3,3,1.0,0.666666666667,1,0.333333333333,2,0.666666666667
1683,1,1,1.0,1.0,0,0.0,1,1.0
1684,2,2,1.0,0.5,1,0.5,1,0.5
1685,2,0,0.0,nan,0,0.0,0,0.0
1686,4,0,0.0,nan,0,0.0,0,0.0
1687,2,1,0.5,1.0,0,0.0,1,0.5
1688,3,1,0.333333333333,1.0,0,0.0,1,0.333333333333
1689,3,1,0.333333333333,1.0,0,0.0,1,0.333333333333
1690,3,2,0.666666666667,1.0,0,0.0,2,0.666666666667
1692,2,2,1.0,0.5,1,0.5,1,0.5
1693,2,1,0.5,1.0,0,0.0,1,0.5
1694,4,3,0.75,0.666666666667,1,0.25,2,0.5
1695,6,3,0.5,0.333333333333,2,0.333333333333,1,0.166666666667
1697,2,1,0.5,1.0,0,0.0,1,0.5
1699,1,0,0.0,nan,0,0.0,0,0.0
1700,1,1,1.0,1.0,0,0.0,1,1.0
1701,2,1,0.5,0.0,1,0.5,0,0.0
1702,4,3,0.75,0.666666666667,1,0.25,2,0.5
1703,2,2,1.0,0.5,1,0.5,1,0.5
1704,4,2,0.5,1.0,0,0.0,2,0.5
1705,3,2,0.666666666667,0.0,2,0.666666666667,0,0.0
1706,2,2,1.0,0.5,1,0.5,1,0.5
1707,3,1,0.333333333333,1.0,0,0.0,1,0.333333333333
1708,5,3,0.6,0.333333333333,2,0.4,1,0.2
1709,2,2,1.0,1.0,0,0.0,2,1.0
1710,1,0,0.0,nan,0,0.0,0,0.0
1711,1,0,0.0,nan,0,0.0,0,0.0
1712,2,1,0.5,1.0,0,0.0,1,0.5
1713,2,2,1.0,1.0,0,0.0,2,1.0
1714,1,0,0.0,nan,0,0.0,0,0.0
1716,3,1,0.333333333333,1.0,0,0.0,1,0.333333333333
1717,3,1,0.333333333333,1.0,0,0.0,1,0.333333333333
1718,4,2,0.5,1.0,0,0.0,2,0.5
1719,1,1,1.0,0.0,1,1.0,0,0.0
1720,4,0,0.0,nan,0,0.0,0,0.0
1721,2,1,0.5,1.0,0,0.0,1,0.5
1724,2,0,0.0,nan,0,0.0,0,0.0
1725,3,2,0.666666666667,1.0,0,0.0,2,0.666666666667
1726,1,1,1.0,0.0,1,1.0,0,0.0
1727,3,0,0.0,nan,0,0.0,0,0.0
1728,2,1,0.5,1.0,0,0.0,1,0.5
1729,1,1,1.0,1.0,0,0.0,1,1.0
1730,3,1,0.333333333333,1.0,0,0.0,1,0.333333333333
1731,1,1,1.0,1.0,0,0.0,1,1.0
1732,2,1,0.5,0.0,1,0.5,0,0.0
1733,3,1,0.333333333333,1.0,0,0.0,1,0.333333333333
1734,1,0,0.0,nan,0,0.0,0,0.0
1735,2,2,1.0,1.0,0,0.0,2,1.0
1736,5,1,0.2,1.0,0,0.0,1,0.2
1737,2,2,1.0,0.0,2,1.0,0,0.0
1738,1,1,1.0,1.0,0,0.0,1,1.0
1739,1,1,1.0,0.0,1,1.0,0,0.0
1740,2,1,0.5,1.0,0,0.0,1,0.5
1742,2,1,0.5,1.0,0,0.0,1,0.5
1743,5,4,0.8,0.75,1,0.2,3,0.6
1744,2,2,1.0,0.5,1,0.5,1,0.5
1745,5,4,0.8,1.0,0,0.0,4,0.8
1746,3,0,0.0,nan,0,0.0,0,0.0
1747,1,0,0.0,nan,0,0.0,0,0.0
1748,3,3,1.0,0.666666666667,1,0.333333333333,2,0.666666666667
1753,1,1,1.0,1.0,0,0.0,1,1.0
1754,3,2,0.666666666667,1.0,0,0.0,2,0.666666666667
1755,2,1,0.5,0.0,1,0.5,0,0.0
1758,1,0,0.0,nan,0,0.0,0,0.0
1759,3,1,0.333333333333,1.0,0,0.0,1,0.333333333333
1760,2,0,0.0,nan,0,0.0,0,0.0
1763,1,0,0.0,nan,0,0.0,0,0.0
1764,3,2,0.666666666667,0.5,1,0.333333333333,1,0.333333333333
1765,3,2,0.666666666667,0.5,1,0.333333333333,1,0.333333333333
1766,4,1,0.25,1.0,0,0.0,1,0.25
1768,2,0,0.0,nan,0,0.0,0,0.0
1769,3,2,0.666666666667,1.0,0,0.0,2,0.666666666667
1770,3,2,0.666666666667,1.0,0,0.0,2,0.666666666667
1771,3,2,0.666666666667,1.0,0,0.0,2,0.666666666667
1772,4,1,0.25,1.0,0,0.0,1,0.25
1773,3,3,1.0,0.666666666667,1,0.333333333333,2,0.666666666667
1774,3,1,0.333333333333,1.0,0,0.0,1,0.333333333333
1775,1,0,0.0,nan,0,0.0,0,0.0
1777,1,1,1.0,1.0,0,0.0,1,1.0
1778,4,1,0.25,0.0,1,0.25,0,0.0
1779,4,4,1.0,1.0,0,0.0,4,1.0
1780,2,2,1.0,1.0,0,0.0,2,1.0
1781,1,0,0.0,nan,0,0.0,0,0.0
1782,1,0,0.0,nan,0,0.0,0,0.0
1784,1,1,1.0,1.0,0,0.0,1,1.0
1785,2,0,0.0,nan,0,0.0,0,0.0
1786,5,2,0.4,0.5,1,0.2,1,0.2
1788,2,2,1.0,1.0,0,0.0,2,1.0
1789,1,1,1.0,1.0,0,0.0,1,1.0
1790,5,3,0.6,0.333333333333,2,0.4,1,0.2
1791,1,0,0.0,nan,0,0.0,0,0.0
1792,1,1,1.0,1.0,0,0.0,1,1.0
1793,1,1,1.0,1.0,0,0.0,1,1.0
1794,1,1,1.0,1.0,0,0.0,1,1.0
1795,1,0,0.0,nan,0,0.0,0,0.0
1796,6,4,0.666666666667,0.75,1,0.166666666667,3,0.5
1797,4,4,1.0,0.75,1,0.25,3,0.75
1799,3,2,0.666666666667,1.0,0,0.0,2,0.666666666667
1800,1,1,1.0,1.0,0,0.0,1,1.0
1804,1,0,0.0,nan,0,0.0,0,0.0
1805,3,2,0.666666666667,1.0,0,0.0,2,0.666666666667
1806,2,2,1.0,1.0,0,0.0,2,1.0
1807,1,0,0.0,nan,0,0.0,0,0.0
1808,3,1,0.333333333333,1.0,0,0.0,1,0.333333333333
1809,1,0,0.0,nan,0,0.0,0,0.0
1810,1,0,0.0,nan,0,0.0,0,0.0
1811,1,1,1.0,1.0,0,0.0,1,1.0
1812,2,1,0.5,1.0,0,0.0,1,0.5
1813,2,2,1.0,0.5,1,0.5,1,0.5
1814,5,4,0.8,0.5,2,0.4,2,0.4
1817,2,1,0.5,1.0,0,0.0,1,0.5
1818,2,1,0.5,1.0,0,0.0,1,0.5
1819,2,0,0.0,nan,0,0.0,0,0.0
1820,2,1,0.5,0.0,1,0.5,0,0.0
1821,3,1,0.333333333333,0.0,1,0.333333333333,0,0.0
1823,2,2,1.0,1.0,0,0.0,2,1.0
1824,3,1,0.333333333333,1.0,0,0.0,1,0.333333333333
1825,2,0,0.0,nan,0,0.0,0,0.0
1829,1,0,0.0,nan,0,0.0,0,0.0
1831,1,1,1.0,1.0,0,0.0,1,1.0
1832,1,1,1.0,0.0,1,1.0,0,0.0
1833,1,0,0.0,nan,0,0.0,0,0.0
1834,3,2,0.666666666667,1.0,0,0.0,2,0.666666666667
1835,1,0,0.0,nan,0,0.0,0,0.0
1836,3,1,0.333333333333,0.0,1,0.333333333333,0,0.0
1837,1,1,1.0,1.0,0,0.0,1,1.0
1840,1,0,0.0,nan,0,0.0,0,0.0
1841,3,3,1.0,0.333333333333,2,0.666666666667,1,0.333333333333
1842,1,1,1.0,1.0,0,0.0,1,1.0
1843,1,1,1.0,1.0,0,0.0,1,1.0
1844,3,2,0.666666666667,0.5,1,0.333333333333,1,0.333333333333
1845,4,2,0.5,1.0,0,0.0,2,0.5
1847,1,1,1.0,1.0,0,0.0,1,1.0
1848,1,0,0.0,nan,0,0.0,0,0.0
1851,1,1,1.0,1.0,0,0.0,1,1.0
1852,1,1,1.0,0.0,1,1.0,0,0.0
1854,1,1,1.0,1.0,0,0.0,1,1.0
1856,1,0,0.0,nan,0,0.0,0,0.0
1857,2,1,0.5,1.0,0,0.0,1,0.5
1858,1,1,1.0,0.0,1,1.0,0,0.0
1859,3,3,1.0,0.666666666667,1,0.333333333333,2,0.666666666667
1861,1,0,0.0,nan,0,0.0,0,0.0
1864,1,0,0.0,nan,0,0.0,0,0.0
1865,2,2,1.0,1.0,0,0.0,2,1.0
1866,2,1,0.5,1.0,0,0.0,1,0.5
1868,2,1,0.5,0.0,1,0.5,0,0.0
1869,2,1,0.5,1.0,0,0.0,1,0.5
1870,1,0,0.0,nan,0,0.0,0,0.0
1871,2,1,0.5,1.0,0,0.0,1,0.5
1872,1,1,1.0,1.0,0,0.0,1,1.0
1873,1,1,1.0,0.0,1,1.0,0,0.0
1874,4,2,0.5,0.5,1,0.25,1,0.25
1875,1,0,0.0,nan,0,0.0,0,0.0
1876,3,3,1.0,1.0,0,0.0,3,1.0
1877,1,1,1.0,0.0,1,1.0,0,0.0
1878,2,1,0.5,1.0,0,0.0,1,0.5
1881,1,0,0.0,nan,0,0.0,0,0.0
1882,3,0,0.0,nan,0,0.0,0,0.0
1883,2,1,0.5,1.0,0,0.0,1,0.5
1884,5,4,0.8,1.0,0,0.0,4,0.8
1885,1,0,0.0,nan,0,0.0,0,0.0
1886,2,1,0.5,0.0,1,0.5,0,0.0
1888,3,1,0.333333333333,1.0,0,0.0,1,0.333333333333
1889,2,1,0.5,1.0,0,0.0,1,0.5
1890,1,0,0.0,nan,0,0.0,0,0.0
1891,1,0,0.0,nan,0,0.0,0,0.0
1893,2,1,0.5,1.0,0,0.0,1,0.5
1894,2,2,1.0,1.0,0,0.0,2,1.0
1895,2,2,1.0,0.5,1,0.5,1,0.5
1898,2,1,0.5,0.0,1,0.5,0,0.0
1899,1,0,0.0,nan,0,0.0,0,0.0
1900,1,0,0.0,nan,0,0.0,0,0.0
1902,1,1,1.0,0.0,1,1.0,0,0.0
1903,1,0,0.0,nan,0,0.0,0,0.0
1904,1,0,0.0,nan,0,0.0,0,0.0
1905,5,3,0.6,1.0,0,0.0,3,0.6
1906,1,1,1.0,1.0,0,0.0,1,1.0
1907,3,2,0.666666666667,1.0,0,0.0,2,0.666666666667
1908,3,2,0.666666666667,0.5,1,0.333333333333,1,0.333333333333
1909,3,1,0.333333333333,1.0,0,0.0,1,0.333333333333
1910,1,0,0.0,nan,0,0.0,0,0.0
1912,1,1,1.0,0.0,1,1.0,0,0.0
1913,2,0,0.0,nan,0,0.0,0,0.0
1914,5,0,0.0,nan,0,0.0,0,0.0
1915,2,1,0.5,1.0,0,0.0,1,0.5
1919,1,1,1.0,1.0,0,0.0,1,1.0
1922,2,2,1.0,1.0,0,0.0,2,1.0
1924,1,1,1.0,1.0,0,0.0,1,1.0
1925,2,2,1.0,0.5,1,0.5,1,0.5
1926,1,1,1.0,0.0,1,1.0,0,0.0
1928,2,1,0.5,1.0,0,0.0,1,0.5
1929,1,1,1.0,0.0,1,1.0,0,0.0
1930,1,1,1.0,1.0,0,0.0,1,1.0
1931,1,1,1.0,1.0,0,0.0,1,1.0
1933,1,1,1.0,1.0,0,0.0,1,1.0
1935,1,1,1.0,1.0,0,0.0,1,1.0
1936,1,0,0.0,nan,0,0.0,0,0.0
1937,1,0,0.0,nan,0,0.0,0,0.0
1938,1,1,1.0,1.0,0,0.0,1,1.0
1939,2,1,0.5,1.0,0,0.0,1,0.5
1942,8,3,0.375,1.0,0,0.0,3,0.375
1943,1,0,0.0,nan,0,0.0,0,0.0
1944,2,2,1.0,1.0,0,0.0,2,1.0
1945,2,1,0.5,1.0,0,0.0,1,0.5
1947,1,0,0.0,nan,0,0.0,0,0.0
1948,2,2,1.0,0.5,1,0.5,1,0.5
1949,1,1,1.0,1.0,0,0.0,1,1.0
1950,4,3,0.75,1.0,0,0.0,3,0.75
1951,3,3,1.0,0.666666666667,1,0.333333333333,2,0.666666666667
1953,1,0,0.0,nan,0,0.0,0,0.0
1954,1,0,0.0,nan,0,0.0,0,0.0
1955,1,1,1.0,1.0,0,0.0,1,1.0
1956,1,1,1.0,0.0,1,1.0,0,0.0
1958,1,1,1.0,1.0,0,0.0,1,1.0
1959,2,1,0.5,1.0,0,0.0,1,0.5
1961,1,1,1.0,0.0,1,1.0,0,0.0
1962,3,1,0.333333333333,1.0,0,0.0,1,0.333333333333
1963,2,2,1.0,0.5,1,0.5,1,0.5
1965,2,1,0.5,0.0,1,0.5,0,0.0
1966,1,0,0.0,nan,0,0.0,0,0.0
1967,2,2,1.0,1.0,0,0.0,2,1.0
1968,2,1,0.5,0.0,1,0.5,0,0.0
1969,1,1,1.0,1.0,0,0.0,1,1.0
1970,1,0,0.0,nan,0,0.0,0,0.0
1972,1,1,1.0,0.0,1,1.0,0,0.0
1973,1,0,0.0,nan,0,0.0,0,0.0
1974,1,0,0.0,nan,0,0.0,0,0.0
1976,1,0,0.0,nan,0,0.0,0,0.0
1979,1,1,1.0,1.0,0,0.0,1,1.0
1980,3,2,0.666666666667,0.5,1,0.333333333333,1,0.333333333333
1982,2,1,0.5,0.0,1,0.5,0,0.0
1984,2,1,0.5,1.0,0,0.0,1,0.5
1985,1,0,0.0,nan,0,0.0,0,0.0
1986,1,0,0.0,nan,0,0.0,0,0.0
1987,2,1,0.5,0.0,1,0.5,0,0.0
1988,1,0,0.0,nan,0,0.0,0,0.0
1989,1,1,1.0,1.0,0,0.0,1,1.0
1992,1,1,1.0,1.0,0,0.0,1,1.0
1994,1,1,1.0,1.0,0,0.0,1,1.0
1995,2,0,0.0,nan,0,0.0,0,0.0
1996,1,1,1.0,1.0,0,0.0,1,1.0
1997,1,1,1.0,1.0,0,0.0,1,1.0
1999,1,1,1.0,0.0,1,1.0,0,0.0
2001,2,1,0.5,1.0,0,0.0,1,0.5
2002,1,1,1.0,1.0,0,0.0,1,1.0
2003,3,3,1.0,0.333333333333,2,0.666666666667,1,0.333333333333
2004,1,1,1.0,1.0,0,0.0,1,1.0
2005,1,1,1.0,0.0,1,1.0,0,0.0
2009,1,1,1.0,1.0,0,0.0,1,1.0
2010,1,0,0.0,nan,0,0.0,0,0.0
2012,3,2,0.666666666667,0.5,1,0.333333333333,1,0.333333333333
2013,5,3,0.6,1.0,0,0.0,3,0.6
2016,1,1,1.0,0.0,1,1.0,0,0.0
2017,2,0,0.0,nan,0,0.0,0,0.0
2019,2,2,1.0,0.5,1,0.5,1,0.5
2020,4,3,0.75,1.0,0,0.0,3,0.75
2021,1,0,0.0,nan,0,0.0,0,0.0
2022,1,1,1.0,0.0,1,1.0,0,0.0
2023,1,1,1.0,1.0,0,0.0,1,1.0
2026,1,1,1.0,0.0,1,1.0,0,0.0
2027,1,0,0.0,nan,0,0.0,0,0.0
2028,2,1,0.5,1.0,0,0.0,1,0.5
2030,1,1,1.0,0.0,1,1.0,0,0.0
2031,1,1,1.0,1.0,0,0.0,1,1.0
2032,5,3,0.6,0.666666666667,1,0.2,2,0.4
2034,2,1,0.5,1.0,0,0.0,1,0.5
2035,2,1,0.5,0.0,1,0.5,0,0.0
2036,2,1,0.5,1.0,0,0.0,1,0.5
2038,1,0,0.0,nan,0,0.0,0,0.0
2039,1,0,0.0,nan,0,0.0,0,0.0
2040,1,0,0.0,nan,0,0.0,0,0.0
2043,2,0,0.0,nan,0,0.0,0,0.0
2046,1,1,1.0,1.0,0,0.0,1,1.0
2049,3,0,0.0,nan,0,0.0,0,0.0
2050,1,1,1.0,0.0,1,1.0,0,0.0
2051,1,1,1.0,1.0,0,0.0,1,1.0
2052,2,2,1.0,1.0,0,0.0,2,1.0
2053,2,2,1.0,1.0,0,0.0,2,1.0
2056,4,3,0.75,0.333333333333,2,0.5,1,0.25
2057,1,1,1.0,1.0,0,0.0,1,1.0
2065,1,1,1.0,1.0,0,0.0,1,1.0
2067,4,4,1.0,1.0,0,0.0,4,1.0
2068,1,0,0.0,nan,0,0.0,0,0.0
2069,2,2,1.0,1.0,0,0.0,2,1.0
2071,1,1,1.0,1.0,0,0.0,1,1.0
2072,2,0,0.0,nan,0,0.0,0,0.0
2073,3,3,1.0,0.333333333333,2,0.666666666667,1,0.333333333333
2074,2,1,0.5,1.0,0,0.0,1,0.5
2076,4,2,0.5,0.5,1,0.25,1,0.25
2077,1,1,1.0,1.0,0,0.0,1,1.0
2082,3,1,0.333333333333,0.0,1,0.333333333333,0,0.0
2085,1,0,0.0,nan,0,0.0,0,0.0
2086,2,0,0.0,nan,0,0.0,0,0.0
2088,1,1,1.0,1.0,0,0.0,1,1.0
2089,1,1,1.0,1.0,0,0.0,1,1.0
2090,2,1,0.5,1.0,0,0.0,1,0.5
2093,2,1,0.5,1.0,0,0.0,1,0.5
2095,3,3,1.0,0.666666666667,1,0.333333333333,2,0.666666666667
2096,1,0,0.0,nan,0,0.0,0,0.0
2097,1,0,0.0,nan,0,0.0,0,0.0
2098,2,2,1.0,1.0,0,0.0,2,1.0
2099,1,0,0.0,nan,0,0.0,0,0.0
2100,1,0,0.0,nan,0,0.0,0,0.0
2103,2,2,1.0,1.0,0,0.0,2,1.0
2104,1,0,0.0,nan,0,0.0,0,0.0
2108,1,0,0.0,nan,0,0.0,0,0.0
2109,2,2,1.0,0.5,1,0.5,1,0.5
2110,1,0,0.0,nan,0,0.0,0,0.0
2113,1,1,1.0,1.0,0,0.0,1,1.0
2114,2,1,0.5,1.0,0,0.0,1,0.5
2115,2,1,0.5,0.0,1,0.5,0,0.0
2117,1,1,1.0,1.0,0,0.0,1,1.0
2118,1,1,1.0,1.0,0,0.0,1,1.0
2121,2,2,1.0,1.0,0,0.0,2,1.0
2123,2,0,0.0,nan,0,0.0,0,0.0
2125,1,0,0.0,nan,0,0.0,0,0.0
2127,1,0,0.0,nan,0,0.0,0,0.0
2128,1,1,1.0,1.0,0,0.0,1,1.0
2129,1,0,0.0,nan,0,0.0,0,0.0
2133,1,1,1.0,1.0,0,0.0,1,1.0
2135,1,0,0.0,nan,0,0.0,0,0.0
2137,2,2,1.0,1.0,0,0.0,2,1.0
2138,1,1,1.0,1.0,0,0.0,1,1.0
2141,1,1,1.0,1.0,0,0.0,1,1.0
2144,2,0,0.0,nan,0,0.0,0,0.0
2145,3,1,0.333333333333,1.0,0,0.0,1,0.333333333333
2147,1,1,1.0,1.0,0,0.0,1,1.0
2152,3,1,0.333333333333,1.0,0,0.0,1,0.333333333333
2153,1,1,1.0,1.0,0,0.0,1,1.0
2157,1,1,1.0,1.0,0,0.0,1,1.0
2158,1,0,0.0,nan,0,0.0,0,0.0
2161,1,1,1.0,1.0,0,0.0,1,1.0
2162,1,1,1.0,1.0,0,0.0,1,1.0
2164,1,0,0.0,nan,0,0.0,0,0.0
2165,1,0,0.0,nan,0,0.0,0,0.0
2168,1,1,1.0,1.0,0,0.0,1,1.0
2170,1,1,1.0,1.0,0,0.0,1,1.0
2171,1,1,1.0,1.0,0,0.0,1,1.0
2173,1,1,1.0,1.0,0,0.0,1,1.0
2174,1,0,0.0,nan,0,0.0,0,0.0
2175,1,1,1.0,1.0,0,0.0,1,1.0
2176,1,0,0.0,nan,0,0.0,0,0.0
2177,2,2,1.0,0.5,1,0.5,1,0.5
2179,1,1,1.0,1.0,0,0.0,1,1.0
2183,2,2,1.0,1.0,0,0.0,2,1.0
2184,1,0,0.0,nan,0,0.0,0,0.0
2185,1,0,0.0,nan,0,0.0,0,0.0
2186,1,1,1.0,1.0,0,0.0,1,1.0
2187,1,1,1.0,1.0,0,0.0,1,1.0
2188,1,1,1.0,0.0,1,1.0,0,0.0
2189,1,1,1.0,1.0,0,0.0,1,1.0
2190,1,0,0.0,nan,0,0.0,0,0.0
2193,2,2,1.0,1.0,0,0.0,2,1.0
2196,1,1,1.0,1.0,0,0.0,1,1.0
2199,1,1,1.0,1.0,0,0.0,1,1.0
2202,1,1,1.0,1.0,0,0.0,1,1.0
2203,1,1,1.0,0.0,1,1.0,0,0.0
2206,1,1,1.0,0.0,1,1.0,0,0.0
2209,1,1,1.0,1.0,0,0.0,1,1.0
2215,1,1,1.0,1.0,0,0.0,1,1.0
2219,1,1,1.0,0.0,1,1.0,0,0.0
2220,1,1,1.0,0.0,1,1.0,0,0.0
2221,1,1,1.0,1.0,0,0.0,1,1.0
2222,2,1,0.5,1.0,0,0.0,1,0.5
2223,1,1,1.0,1.0,0,0.0,1,1.0
2225,1,1,1.0,1.0,0,0.0,1,1.0
2226,1,0,0.0,nan,0,0.0,0,0.0
2228,1,0,0.0,nan,0,0.0,0,0.0
2229,1,1,1.0,1.0,0,0.0,1,1.0
2230,2,2,1.0,1.0,0,0.0,2,1.0
2231,1,1,1.0,0.0,1,1.0,0,0.0
2233,3,1,0.333333333333,1.0,0,0.0,1,0.333333333333
2234,1,1,1.0,1.0,0,0.0,1,1.0
2236,1,0,0.0,nan,0,0.0,0,0.0
2237,3,1,0.333333333333,0.0,1,0.333333333333,0,0.0
2239,1,1,1.0,1.0,0,0.0,1,1.0
2244,2,1,0.5,1.0,0,0.0,1,0.5
2247,1,0,0.0,nan,0,0.0,0,0.0
2249,3,2,0.666666666667,1.0,0,0.0,2,0.666666666667
2250,2,1,0.5,1.0,0,0.0,1,0.5
2251,1,0,0.0,nan,0,0.0,0,0.0
2252,2,2,1.0,1.0,0,0.0,2,1.0
2254,2,0,0.0,nan,0,0.0,0,0.0
2256,1,1,1.0,1.0,0,0.0,1,1.0
2257,1,0,0.0,nan,0,0.0,0,0.0
2259,1,1,1.0,1.0,0,0.0,1,1.0
2261,1,1,1.0,1.0,0,0.0,1,1.0
2262,2,1,0.5,1.0,0,0.0,1,0.5
2264,1,1,1.0,1.0,0,0.0,1,1.0
2265,1,0,0.0,nan,0,0.0,0,0.0
2267,1,1,1.0,0.0,1,1.0,0,0.0
2269,1,1,1.0,1.0,0,0.0,1,1.0
2271,1,0,0.0,nan,0,0.0,0,0.0
2275,1,0,0.0,nan,0,0.0,0,0.0
2277,2,1,0.5,1.0,0,0.0,1,0.5
2280,1,1,1.0,1.0,0,0.0,1,1.0
2284,2,1,0.5,1.0,0,0.0,1,0.5
2286,1,1,1.0,0.0,1,1.0,0,0.0
2288,3,0,0.0,nan,0,0.0,0,0.0
2289,2,0,0.0,nan,0,0.0,0,0.0
2291,1,1,1.0,1.0,0,0.0,1,1.0
2292,1,0,0.0,nan,0,0.0,0,0.0
2293,3,2,0.666666666667,0.5,1,0.333333333333,1,0.333333333333
2294,2,1,0.5,1.0,0,0.0,1,0.5
2297,1,1,1.0,1.0,0,0.0,1,1.0
2299,1,0,0.0,nan,0,0.0,0,0.0
2306,2,1,0.5,0.0,1,0.5,0,0.0
2307,2,1,0.5,1.0,0,0.0,1,0.5
2308,1,1,1.0,1.0,0,0.0,1,1.0
2309,2,1,0.5,1.0,0,0.0,1,0.5
2310,1,1,1.0,0.0,1,1.0,0,0.0
2311,2,2,1.0,0.5,1,0.5,1,0.5
2314,4,2,0.5,1.0,0,0.0,2,0.5
2317,1,0,0.0,nan,0,0.0,0,0.0
2319,1,1,1.0,1.0,0,0.0,1,1.0
2321,1,1,1.0,1.0,0,0.0,1,1.0
2323,1,1,1.0,1.0,0,0.0,1,1.0
2324,1,1,1.0,1.0,0,0.0,1,1.0
2325,2,1,0.5,1.0,0,0.0,1,0.5
2327,1,0,0.0,nan,0,0.0,0,0.0
2333,1,0,0.0,nan,0,0.0,0,0.0
2338,1,0,0.0,nan,0,0.0,0,0.0
2343,1,0,0.0,nan,0,0.0,0,0.0
2344,1,0,0.0,nan,0,0.0,0,0.0
2346,2,2,1.0,0.5,1,0.5,1,0.5
2355,1,1,1.0,1.0,0,0.0,1,1.0
2358,1,1,1.0,1.0,0,0.0,1,1.0
2362,1,0,0.0,nan,0,0.0,0,0.0
2363,1,1,1.0,0.0,1,1.0,0,0.0
2364,2,2,1.0,0.5,1,0.5,1,0.5
2369,1,1,1.0,0.0,1,1.0,0,0.0
2370,1,1,1.0,1.0,0,0.0,1,1.0
2375,2,1,0.5,1.0,0,0.0,1,0.5
2378,1,1,1.0,1.0,0,0.0,1,1.0
2379,1,0,0.0,nan,0,0.0,0,0.0
2381,1,0,0.0,nan,0,0.0,0,0.0
2382,1,1,1.0,1.0,0,0.0,1,1.0
2383,1,0,0.0,nan,0,0.0,0,0.0
2384,1,0,0.0,nan,0,0.0,0,0.0
2386,1,1,1.0,1.0,0,0.0,1,1.0
2391,1,1,1.0,1.0,0,0.0,1,1.0
2393,1,1,1.0,0.0,1,1.0,0,0.0
2399,2,1,0.5,1.0,0,0.0,1,0.5
2400,1,0,0.0,nan,0,0.0,0,0.0
2401,1,1,1.0,1.0,0,0.0,1,1.0
2402,2,1,0.5,1.0,0,0.0,1,0.5
2403,1,1,1.0,0.0,1,1.0,0,0.0
2404,1,1,1.0,1.0,0,0.0,1,1.0
2406,1,1,1.0,1.0,0,0.0,1,1.0
2411,2,1,0.5,1.0,0,0.0,1,0.5
2413,1,1,1.0,1.0,0,0.0,1,1.0
2415,2,2,1.0,0.0,2,1.0,0,0.0
2416,1,0,0.0,nan,0,0.0,0,0.0
2418,1,1,1.0,1.0,0,0.0,1,1.0
2425,1,1,1.0,1.0,0,0.0,1,1.0
2426,2,1,0.5,1.0,0,0.0,1,0.5
2427,1,1,1.0,1.0,0,0.0,1,1.0
2428,1,0,0.0,nan,0,0.0,0,0.0
2430,1,1,1.0,1.0,0,0.0,1,1.0
2431,1,0,0.0,nan,0,0.0,0,0.0
2434,1,1,1.0,0.0,1,1.0,0,0.0
2439,2,0,0.0,nan,0,0.0,0,0.0
2444,1,0,0.0,nan,0,0.0,0,0.0
2447,1,1,1.0,1.0,0,0.0,1,1.0
2448,1,0,0.0,nan,0,0.0,0,0.0
2449,2,2,1.0,0.5,1,0.5,1,0.5
2452,1,1,1.0,1.0,0,0.0,1,1.0
2453,1,1,1.0,1.0,0,0.0,1,1.0
2456,1,0,0.0,nan,0,0.0,0,0.0
2459,1,1,1.0,1.0,0,0.0,1,1.0
2465,1,0,0.0,nan,0,0.0,0,0.0
2467,1,0,0.0,nan,0,0.0,0,0.0
2470,1,1,1.0,1.0,0,0.0,1,1.0
2471,1,0,0.0,nan,0,0.0,0,0.0
2473,1,1,1.0,0.0,1,1.0,0,0.0
2477,1,0,0.0,nan,0,0.0,0,0.0
2479,1,1,1.0,1.0,0,0.0,1,1.0
2480,1,1,1.0,1.0,0,0.0,1,1.0
2481,1,0,0.0,nan,0,0.0,0,0.0
2482,1,0,0.0,nan,0,0.0,0,0.0
2483,1,0,0.0,nan,0,0.0,0,0.0
2486,2,1,0.5,1.0,0,0.0,1,0.5
2489,1,1,1.0,1.0,0,0.0,1,1.0
2493,1,1,1.0,1.0,0,0.0,1,1.0
2494,1,0,0.0,nan,0,0.0,0,0.0
2498,1,0,0.0,nan,0,0.0,0,0.0
2500,1,1,1.0,1.0,0,0.0,1,1.0
2502,1,1,1.0,1.0,0,0.0,1,1.0
2503,2,1,0.5,1.0,0,0.0,1,0.5
2504,1,0,0.0,nan,0,0.0,0,0.0
2505,1,1,1.0,0.0,1,1.0,0,0.0
2507,2,1,0.5,1.0,0,0.0,1,0.5
2511,1,1,1.0,0.0,1,1.0,0,0.0
2512,1,1,1.0,0.0,1,1.0,0,0.0
2513,1,1,1.0,1.0,0,0.0,1,1.0
2516,2,1,0.5,1.0,0,0.0,1,0.5
2520,1,1,1.0,1.0,0,0.0,1,1.0
2521,1,0,0.0,nan,0,0.0,0,0.0
2522,1,0,0.0,nan,0,0.0,0,0.0
2524,1,0,0.0,nan,0,0.0,0,0.0
2527,1,0,0.0,nan,0,0.0,0,0.0
2532,2,2,1.0,1.0,0,0.0,2,1.0
2534,2,0,0.0,nan,0,0.0,0,0.0
2535,1,0,0.0,nan,0,0.0,0,0.0
2542,2,1,0.5,0.0,1,0.5,0,0.0
2545,2,0,0.0,nan,0,0.0,0,0.0
2546,1,1,1.0,1.0,0,0.0,1,1.0
2549,1,0,0.0,nan,0,0.0,0,0.0
2553,2,1,0.5,1.0,0,0.0,1,0.5
2554,1,0,0.0,nan,0,0.0,0,0.0
2558,1,0,0.0,nan,0,0.0,0,0.0
2559,1,1,1.0,1.0,0,0.0,1,1.0
2560,1,0,0.0,nan,0,0.0,0,0.0
2572,1,1,1.0,1.0,0,0.0,1,1.0
2573,1,1,1.0,0.0,1,1.0,0,0.0
2574,1,1,1.0,1.0,0,0.0,1,1.0
2579,1,0,0.0,nan,0,0.0,0,0.0
2583,1,1,1.0,1.0,0,0.0,1,1.0
2585,2,1,0.5,0.0,1,0.5,0,0.0
2586,1,0,0.0,nan,0,0.0,0,0.0
2590,1,1,1.0,1.0,0,0.0,1,1.0
2594,2,1,0.5,1.0,0,0.0,1,0.5
2598,1,1,1.0,0.0,1,1.0,0,0.0
2601,1,1,1.0,0.0,1,1.0,0,0.0
2603,1,1,1.0,1.0,0,0.0,1,1.0
2604,1,0,0.0,nan,0,0.0,0,0.0
2605,1,0,0.0,nan,0,0.0,0,0.0
2608,1,0,0.0,nan,0,0.0,0,0.0
2610,1,0,0.0,nan,0,0.0,0,0.0
2618,1,0,0.0,nan,0,0.0,0,0.0
2627,2,1,0.5,1.0,0,0.0,1,0.5
2632,1,1,1.0,1.0,0,0.0,1,1.0
2638,1,1,1.0,1.0,0,0.0,1,1.0
2639,1,0,0.0,nan,0,0.0,0,0.0
2641,1,0,0.0,nan,0,0.0,0,0.0
2643,1,0,0.0,nan,0,0.0,0,0.0
2644,1,1,1.0,1.0,0,0.0,1,1.0
2645,1,1,1.0,1.0,0,0.0,1,1.0
2648,1,1,1.0,1.0,0,0.0,1,1.0
2649,1,1,1.0,1.0,0,0.0,1,1.0
2651,1,0,0.0,nan,0,0.0,0,0.0
2652,1,1,1.0,0.0,1,1.0,0,0.0
2653,1,1,1.0,1.0,0,0.0,1,1.0
2659,2,0,0.0,nan,0,0.0,0,0.0
2663,1,0,0.0,nan,0,0.0,0,0.0
2665,1,1,1.0,1.0,0,0.0,1,1.0
2668,2,2,1.0,0.5,1,0.5,1,0.5
2670,1,1,1.0,1.0,0,0.0,1,1.0
2674,2,2,1.0,0.0,2,1.0,0,0.0
2676,1,1,1.0,1.0,0,0.0,1,1.0
2683,1,0,0.0,nan,0,0.0,0,0.0
2685,1,1,1.0,1.0,0,0.0,1,1.0
2686,1,1,1.0,1.0,0,0.0,1,1.0
2688,2,1,0.5,0.0,1,0.5,0,0.0
2692,2,2,1.0,1.0,0,0.0,2,1.0
2694,1,0,0.0,nan,0,0.0,0,0.0
2699,1,1,1.0,0.0,1,1.0,0,0.0
2700,1,1,1.0,1.0,0,0.0,1,1.0
2701,1,0,0.0,nan,0,0.0,0,0.0
2703,1,0,0.0,nan,0,0.0,0,0.0
2704,1,0,0.0,nan,0,0.0,0,0.0
2706,1,0,0.0,nan,0,0.0,0,0.0
2707,1,1,1.0,1.0,0,0.0,1,1.0
2713,1,1,1.0,1.0,0,0.0,1,1.0
2716,1,0,0.0,nan,0,0.0,0,0.0
2717,1,0,0.0,nan,0,0.0,0,0.0
2721,1,1,1.0,0.0,1,1.0,0,0.0
2727,1,0,0.0,nan,0,0.0,0,0.0
2730,1,0,0.0,nan,0,0.0,0,0.0
2731,1,0,0.0,nan,0,0.0,0,0.0
2734,1,1,1.0,0.0,1,1.0,0,0.0
2738,1,0,0.0,nan,0,0.0,0,0.0
2739,1,1,1.0,1.0,0,0.0,1,1.0
2742,1,1,1.0,1.0,0,0.0,1,1.0
2745,1,1,1.0,0.0,1,1.0,0,0.0
2746,2,1,0.5,0.0,1,0.5,0,0.0
2752,1,1,1.0,1.0,0,0.0,1,1.0
2753,1,1,1.0,1.0,0,0.0,1,1.0
2755,1,0,0.0,nan,0,0.0,0,0.0
2759,1,1,1.0,1.0,0,0.0,1,1.0
2765,1,0,0.0,nan,0,0.0,0,0.0
2785,1,0,0.0,nan,0,0.0,0,0.0
2786,1,1,1.0,1.0,0,0.0,1,1.0
2787,1,1,1.0,1.0,0,0.0,1,1.0
2790,2,0,0.0,nan,0,0.0,0,0.0
2792,2,1,0.5,0.0,1,0.5,0,0.0
2793,1,1,1.0,1.0,0,0.0,1,1.0
2797,1,0,0.0,nan,0,0.0,0,0.0
2800,1,1,1.0,1.0,0,0.0,1,1.0
2805,1,0,0.0,nan,0,0.0,0,0.0
2813,1,1,1.0,1.0,0,0.0,1,1.0
2818,1,1,1.0,0.0,1,1.0,0,0.0
2826,1,0,0.0,nan,0,0.0,0,0.0
2828,1,0,0.0,nan,0,0.0,0,0.0
2831,1,1,1.0,1.0,0,0.0,1,1.0
2835,1,1,1.0,1.0,0,0.0,1,1.0
2839,1,1,1.0,1.0,0,0.0,1,1.0
2842,3,2,0.666666666667,1.0,0,0.0,2,0.666666666667
2843,1,1,1.0,1.0,0,0.0,1,1.0
2845,1,0,0.0,nan,0,0.0,0,0.0
2846,1,1,1.0,1.0,0,0.0,1,1.0
2847,1,1,1.0,1.0,0,0.0,1,1.0
2853,2,1,0.5,1.0,0,0.0,1,0.5
2854,1,1,1.0,1.0,0,0.0,1,1.0
2857,1,1,1.0,1.0,0,0.0,1,1.0
2862,1,1,1.0,0.0,1,1.0,0,0.0
2863,1,1,1.0,1.0,0,0.0,1,1.0
2867,1,0,0.0,nan,0,0.0,0,0.0
2869,1,1,1.0,1.0,0,0.0,1,1.0
2871,1,0,0.0,nan,0,0.0,0,0.0
2872,1,1,1.0,1.0,0,0.0,1,1.0
2875,1,0,0.0,nan,0,0.0,0,0.0
2876,1,1,1.0,1.0,0,0.0,1,1.0
2881,2,0,0.0,nan,0,0.0,0,0.0
2885,1,1,1.0,1.0,0,0.0,1,1.0
2889,1,1,1.0,1.0,0,0.0,1,1.0
2904,1,0,0.0,nan,0,0.0,0,0.0
2913,1,1,1.0,1.0,0,0.0,1,1.0
2930,1,1,1.0,1.0,0,0.0,1,1.0
2931,1,0,0.0,nan,0,0.0,0,0.0
2937,1,0,0.0,nan,0,0.0,0,0.0
2953,1,0,0.0,nan,0,0.0,0,0.0
2957,1,0,0.0,nan,0,0.0,0,0.0
2960,2,1,0.5,1.0,0,0.0,1,0.5
2961,1,1,1.0,1.0,0,0.0,1,1.0
2963,1,0,0.0,nan,0,0.0,0,0.0
2966,1,0,0.0,nan,0,0.0,0,0.0
2971,1,1,1.0,1.0,0,0.0,1,1.0
2978,1,1,1.0,0.0,1,1.0,0,0.0
2979,1,0,0.0,nan,0,0.0,0,0.0
2982,1,0,0.0,nan,0,0.0,0,0.0
2987,1,1,1.0,1.0,0,0.0,1,1.0
2995,1,1,1.0,0.0,1,1.0,0,0.0
2997,1,0,0.0,nan,0,0.0,0,0.0
3001,1,1,1.0,1.0,0,0.0,1,1.0
3006,1,0,0.0,nan,0,0.0,0,0.0
3011,1,0,0.0,nan,0,0.0,0,0.0
3017,1,1,1.0,1.0,0,0.0,1,1.0
3032,1,1,1.0,0.0,1,1.0,0,0.0
3040,1,1,1.0,1.0,0,0.0,1,1.0
3042,1,0,0.0,nan,0,0.0,0,0.0
3050,1,0,0.0,nan,0,0.0,0,0.0
3055,2,1,0.5,1.0,0,0.0,1,0.5
3056,1,1,1.0,1.0,0,0.0,1,1.0
3059,1,0,0.0,nan,0,0.0,0,0.0
3061,1,0,0.0,nan,0,0.0,0,0.0
3070,1,0,0.0,nan,0,0.0,0,0.0
3084,2,2,1.0,1.0,0,0.0,2,1.0
3091,1,1,1.0,0.0,1,1.0,0,0.0
3101,1,1,1.0,1.0,0,0.0,1,1.0
3109,1,1,1.0,1.0,0,0.0,1,1.0
3113,1,0,0.0,nan,0,0.0,0,0.0
3116,1,1,1.0,0.0,1,1.0,0,0.0
3122,1,1,1.0,1.0,0,0.0,1,1.0
3125,1,1,1.0,0.0,1,1.0,0,0.0
3134,1,1,1.0,1.0,0,0.0,1,1.0
3149,2,1,0.5,1.0,0,0.0,1,0.5
3155,1,1,1.0,1.0,0,0.0,1,1.0
3167,2,2,1.0,0.5,1,0.5,1,0.5
3189,1,0,0.0,nan,0,0.0,0,0.0
3202,1,1,1.0,0.0,1,1.0,0,0.0
3204,1,1,1.0,1.0,0,0.0,1,1.0
3209,1,1,1.0,1.0,0,0.0,1,1.0
3211,1,1,1.0,1.0,0,0.0,1,1.0
3218,1,1,1.0,1.0,0,0.0,1,1.0
3222,1,1,1.0,0.0,1,1.0,0,0.0
3230,1,0,0.0,nan,0,0.0,0,0.0
3235,1,0,0.0,nan,0,0.0,0,0.0
3238,1,0,0.0,nan,0,0.0,0,0.0
3254,1,0,0.0,nan,0,0.0,0,0.0
3256,1,0,0.0,nan,0,0.0,0,0.0
3263,1,1,1.0,1.0,0,0.0,1,1.0
3279,1,1,1.0,1.0,0,0.0,1,1.0
3284,2,1,0.5,0.0,1,0.5,0,0.0
3285,1,0,0.0,nan,0,0.0,0,0.0
3290,1,0,0.0,nan,0,0.0,0,0.0
3291,1,1,1.0,1.0,0,0.0,1,1.0
3310,1,0,0.0,nan,0,0.0,0,0.0
3328,1,0,0.0,nan,0,0.0,0,0.0
3339,1,0,0.0,nan,0,0.0,0,0.0
3342,1,1,1.0,1.0,0,0.0,1,1.0
3350,1,1,1.0,0.0,1,1.0,0,0.0
3362,1,1,1.0,1.0,0,0.0,1,1.0
3368,1,0,0.0,nan,0,0.0,0,0.0
3370,1,1,1.0,1.0,0,0.0,1,1.0
3373,1,0,0.0,nan,0,0.0,0,0.0
3377,2,2,1.0,1.0,0,0.0,2,1.0
3380,1,0,0.0,nan,0,0.0,0,0.0
3396,1,0,0.0,nan,0,0.0,0,0.0
3404,1,1,1.0,1.0,0,0.0,1,1.0
3405,2,1,0.5,1.0,0,0.0,1,0.5
3421,1,1,1.0,1.0,0,0.0,1,1.0
3427,1,1,1.0,1.0,0,0.0,1,1.0
3437,1,1,1.0,0.0,1,1.0,0,0.0
3443,1,1,1.0,1.0,0,0.0,1,1.0
3453,1,0,0.0,nan,0,0.0,0,0.0
3456,1,1,1.0,0.0,1,1.0,0,0.0
3480,1,1,1.0,1.0,0,0.0,1,1.0
3490,1,1,1.0,1.0,0,0.0,1,1.0
3496,1,1,1.0,1.0,0,0.0,1,1.0
3511,1,1,1.0,1.0,0,0.0,1,1.0
3550,1,0,0.0,nan,0,0.0,0,0.0
3551,1,1,1.0,0.0,1,1.0,0,0.0
3552,1,0,0.0,nan,0,0.0,0,0.0
3573,3,1,0.333333333333,1.0,0,0.0,1,0.333333333333
3576,1,0,0.0,nan,0,0.0,0,0.0
3581,1,0,0.0,nan,0,0.0,0,0.0
3657,1,1,1.0,1.0,0,0.0,1,1.0
3658,1,0,0.0,nan,0,0.0,0,0.0
3659,1,0,0.0,nan,0,0.0,0,0.0
3661,1,0,0.0,nan,0,0.0,0,0.0
3690,1,1,1.0,1.0,0,0.0,1,1.0
3694,1,0,0.0,nan,0,0.0,0,0.0
3704,1,0,0.0,nan,0,0.0,0,0.0
3720,1,1,1.0,1.0,0,0.0,1,1.0
3743,1,0,0.0,nan,0,0.0,0,0.0
3771,1,0,0.0,nan,0,0.0,0,0.0
3778,1,1,1.0,1.0,0,0.0,1,1.0
3782,1,0,0.0,nan,0,0.0,0,0.0
3786,1,1,1.0,0.0,1,1.0,0,0.0
3796,1,0,0.0,nan,0,0.0,0,0.0
3802,1,0,0.0,nan,0,0.0,0,0.0
3806,1,1,1.0,0.0,1,1.0,0,0.0
3843,1,0,0.0,nan,0,0.0,0,0.0
3862,1,1,1.0,1.0,0,0.0,1,1.0
3871,1,1,1.0,1.0,0,0.0,1,1.0
3872,1,0,0.0,nan,0,0.0,0,0.0
3877,1,0,0.0,nan,0,0.0,0,0.0
3881,1,0,0.0,nan,0,0.0,0,0.0
3892,1,0,0.0,nan,0,0.0,0,0.0
3932,1,0,0.0,nan,0,0.0,0,0.0
3934,1,1,1.0,1.0,0,0.0,1,1.0
3942,1,0,0.0,nan,0,0.0,0,0.0
3986,1,0,0.0,nan,0,0.0,0,0.0
3989,1,1,1.0,0.0,1,1.0,0,0.0
3991,1,0,0.0,nan,0,0.0,0,0.0
4001,1,0,0.0,nan,0,0.0,0,0.0
4011,1,1,1.0,0.0,1,1.0,0,0.0
4013,1,1,1.0,1.0,0,0.0,1,1.0
4017,1,1,1.0,1.0,0,0.0,1,1.0
4040,1,1,1.0,1.0,0,0.0,1,1.0
4045,2,1,0.5,0.0,1,0.5,0,0.0
4050,1,0,0.0,nan,0,0.0,0,0.0
4056,1,1,1.0,1.0,0,0.0,1,1.0
4061,1,1,1.0,1.0,0,0.0,1,1.0
4068,1,0,0.0,nan,0,0.0,0,0.0
4081,1,1,1.0,1.0,0,0.0,1,1.0
4088,1,0,0.0,nan,0,0.0,0,0.0
4093,1,1,1.0,1.0,0,0.0,1,1.0
4095,1,0,0.0,nan,0,0.0,0,0.0
4130,1,0,0.0,nan,0,0.0,0,0.0
4136,1,1,1.0,1.0,0,0.0,1,1.0
4149,1,0,0.0,nan,0,0.0,0,0.0
4155,1,0,0.0,nan,0,0.0,0,0.0
4158,1,1,1.0,1.0,0,0.0,1,1.0
4173,1,1,1.0,1.0,0,0.0,1,1.0
4222,1,0,0.0,nan,0,0.0,0,0.0
4234,1,1,1.0,1.0,0,0.0,1,1.0
4250,1,0,0.0,nan,0,0.0,0,0.0
4257,1,0,0.0,nan,0,0.0,0,0.0
4270,1,0,0.0,nan,0,0.0,0,0.0
4278,1,0,0.0,nan,0,0.0,0,0.0
4298,1,0,0.0,nan,0,0.0,0,0.0
4315,1,0,0.0,nan,0,0.0,0,0.0
4373,1,1,1.0,1.0,0,0.0,1,1.0
4420,1,0,0.0,nan,0,0.0,0,0.0
4426,1,0,0.0,nan,0,0.0,0,0.0
4448,1,1,1.0,0.0,1,1.0,0,0.0
4481,1,0,0.0,nan,0,0.0,0,0.0
4538,1,1,1.0,0.0,1,1.0,0,0.0
4588,1,1,1.0,0.0,1,1.0,0,0.0
4594,1,0,0.0,nan,0,0.0,0,0.0
4608,1,0,0.0,nan,0,0.0,0,0.0
4662,1,0,0.0,nan,0,0.0,0,0.0
4694,1,0,0.0,nan,0,0.0,0,0.0
4736,1,1,1.0,1.0,0,0.0,1,1.0
4744,1,1,1.0,1.0,0,0.0,1,1.0
4748,1,1,1.0,1.0,0,0.0,1,1.0
4802,1,0,0.0,nan,0,0.0,0,0.0
4814,1,1,1.0,1.0,0,0.0,1,1.0
4826,1,0,0.0,nan,0,0.0,0,0.0
4833,1,1,1.0,1.0,0,0.0,1,1.0
4837,1,0,0.0,nan,0,0.0,0,0.0
4901,1,1,1.0,1.0,0,0.0,1,1.0
4917,1,1,1.0,0.0,1,1.0,0,0.0
4948,1,1,1.0,1.0,0,0.0,1,1.0
4952,1,1,1.0,0.0,1,1.0,0,0.0
4958,1,1,1.0,1.0,0,0.0,1,1.0
4965,1,1,1.0,1.0,0,0.0,1,1.0
4976,1,1,1.0,1.0,0,0.0,1,1.0
4983,1,0,0.0,nan,0,0.0,0,0.0
5008,1,0,0.0,nan,0,0.0,0,0.0
5093,1,0,0.0,nan,0,0.0,0,0.0
5098,1,1,1.0,1.0,0,0.0,1,1.0
5131,1,1,1.0,1.0,0,0.0,1,1.0
5135,1,1,1.0,1.0,0,0.0,1,1.0
5188,1,1,1.0,0.0,1,1.0,0,0.0
5244,1,0,0.0,nan,0,0.0,0,0.0
5251,1,0,0.0,nan,0,0.0,0,0.0
5341,1,0,0.0,nan,0,0.0,0,0.0
5354,1,1,1.0,1.0,0,0.0,1,1.0
5366,1,0,0.0,nan,0,0.0,0,0.0
5446,1,1,1.0,1.0,0,0.0,1,1.0
5470,1,0,0.0,nan,0,0.0,0,0.0
5485,1,0,0.0,nan,0,0.0,0,0.0
5492,1,1,1.0,0.0,1,1.0,0,0.0
5498,1,0,0.0,nan,0,0.0,0,0.0
5517,1,0,0.0,nan,0,0.0,0,0.0
5537,1,1,1.0,1.0,0,0.0,1,1.0
5539,1,0,0.0,nan,0,0.0,0,0.0
5540,1,0,0.0,nan,0,0.0,0,0.0
5591,1,1,1.0,1.0,0,0.0,1,1.0
5600,1,1,1.0,0.0,1,1.0,0,0.0
5680,1,1,1.0,1.0,0,0.0,1,1.0
5742,1,0,0.0,nan,0,0.0,0,0.0
5895,1,0,0.0,nan,0,0.0,0,0.0
5920,1,0,0.0,nan,0,0.0,0,0.0
5926,1,1,1.0,1.0,0,0.0,1,1.0
5988,1,0,0.0,nan,0,0.0,0,0.0
6014,1,1,1.0,1.0,0,0.0,1,1.0
6320,1,0,0.0,nan,0,0.0,0,0.0
6381,1,1,1.0,0.0,1,1.0,0,0.0
6560,1,1,1.0,1.0,0,0.0,1,1.0
6637,1,1,1.0,1.0,0,0.0,1,1.0
6656,1,1,1.0,1.0,0,0.0,1,1.0
6659,1,1,1.0,0.0,1,1.0,0,0.0
6698,1,1,1.0,1.0,0,0.0,1,1.0
6773,1,0,0.0,nan,0,0.0,0,0.0
6862,1,1,1.0,1.0,0,0.0,1,1.0
6945,1,1,1.0,1.0,0,0.0,1,1.0
7014,1,1,1.0,1.0,0,0.0,1,1.0
7084,1,1,1.0,1.0,0,0.0,1,1.0
7312,1,1,1.0,1.0,0,0.0,1,1.0
7403,1,1,1.0,1.0,0,0.0,1,1.0
7426,1,0,0.0,nan,0,0.0,0,0.0
7462,1,0,0.0,nan,0,0.0,0,0.0
7897,1,0,0.0,nan,0,0.0,0,0.0
8193,1,0,0.0,nan,0,0.0,0,0.0
9218,1,0,0.0,nan,0,0.0,0,0.0
9273,1,0,0.0,nan,0,0.0,0,0.0
9291,1,1,1.0,1.0,0,0.0,1,1.0
9489,1,0,0.0,nan,0,0.0,0,0.0
9774,1,1,1.0,1.0,0,0.0,1,1.0
10730,1,0,0.0,nan,0,0.0,0,0.0
10794,1,0,0.0,nan,0,0.0,0,0.0
10976,1,0,0.0,nan,0,0.0,0,0.0
11009,1,1,1.0,0.0,1,1.0,0,0.0
11718,1,1,1.0,0.0,1,1.0,0,0.0
